,Market and Exchange Names,As of Date in Form YYYY-MM-DD,Noncommercial Positions-Long (All),Noncommercial Positions-Short (All),Change in Noncommercial-Long (All),Change in Noncommercial-Short (All),Open Interest (All),Change in Open Interest (All),Net Positions
0,JAPANESE YEN - CHICAGO MERCANTILE EXCHANGE,2025-01-28,96809,97768,    2652,  -11062,216788,    5168,-959
1,JAPANESE YEN - CHICAGO MERCANTILE EXCHANGE,2025-01-21,94157,108830,    2723,  -12015,211620,  -12332,-14673
2,JAPANESE YEN - CHICAGO MERCANTILE EXCHANGE,2025-01-14,91434,120845,     228,    9450,223952,   11496,-29411
3,JAPANESE YEN - CHICAGO MERCANTILE EXCHANGE,2025-01-07,91206,111395,   -4913,    6833,212456,    5485,-20189
4,JAPANESE YEN - CHICAGO MERCANTILE EXCHANGE,2024-12-31,96119,104562,     161,   10915,206971,    6251,-8443
5,JAPANESE YEN - CHICAGO MERCANTILE EXCHANGE,2024-12-24,95958,93647,    8750,   12400,200720,   19047,2311
6,JAPANESE YEN - CHICAGO MERCANTILE EXCHANGE,2024-12-17,87208,81247,  -10730,    9061,181673,  -93161,5961
7,JAPANESE YEN - CHICAGO MERCANTILE EXCHANGE,2024-12-10,97938,72186,    4316,  -19102,274834,   17985,25752
8,JAPANESE YEN - CHICAGO MERCANTILE EXCHANGE,2024-12-03,93622,91288,    6025,  -18942,256849,    3283,2334
9,JAPANESE YEN - CHICAGO MERCANTILE EXCHANGE,2024-11-26,87597,110230,    8624,  -15611,253566,    -521,-22633
10,JAPANESE YEN - CHICAGO MERCANTILE EXCHANGE,2024-11-19,78973,125841,   14935,   -3099,254087,   -3601,-46868
11,JAPANESE YEN - CHICAGO MERCANTILE EXCHANGE,2024-11-12,64038,128940,    3704,   24439,257688,   21926,-64902
12,JAPANESE YEN - CHICAGO MERCANTILE EXCHANGE,2024-11-05,60334,104501,   -4591,   14759,235762,    9868,-44167
13,JAPANESE YEN - CHICAGO MERCANTILE EXCHANGE,2024-10-29,64925,89742,  -14439,   23149,225894,   18556,-24817
14,JAPANESE YEN - CHICAGO MERCANTILE EXCHANGE,2024-10-22,79364,66593,   -7321,   14018,207338,    9467,12771
15,JAPANESE YEN - CHICAGO MERCANTILE EXCHANGE,2024-10-15,86685,52575,    3006,    5424,197871,    1186,34110
16,JAPANESE YEN - CHICAGO MERCANTILE EXCHANGE,2024-10-08,83679,47151,  -11834,    8410,196685,     485,36528
17,JAPANESE YEN - CHICAGO MERCANTILE EXCHANGE,2024-10-01,95513,38741,   -9177,      62,196200,  -11502,56772
18,JAPANESE YEN - CHICAGO MERCANTILE EXCHANGE,2024-09-24,104690,38679,    7358,   -1813,207702,    8239,66011
19,JAPANESE YEN - CHICAGO MERCANTILE EXCHANGE,2024-09-17,97332,40492,   -1562,   -2632,199463, -177051,56840
20,JAPANESE YEN - CHICAGO MERCANTILE EXCHANGE,2024-09-10,98894,43124,    7103,   -7551,376514,   49719,55770
21,JAPANESE YEN - CHICAGO MERCANTILE EXCHANGE,2024-09-03,91791,50675,    7486,   -7762,326795,    8536,41116
22,JAPANESE YEN - CHICAGO MERCANTILE EXCHANGE,2024-08-27,84305,58437,   -4456,   -6739,318259,    2062,25868
23,JAPANESE YEN - CHICAGO MERCANTILE EXCHANGE,2024-08-20,88761,65176,    1660,    1179,316197,     859,23585
24,JAPANESE YEN - CHICAGO MERCANTILE EXCHANGE,2024-08-13,87101,63997,   20932,  -13526,315338,   16401,23104
25,JAPANESE YEN - CHICAGO MERCANTILE EXCHANGE,2024-08-06,66169,77523,    1153,  -60953,298937,   -4214,-11354
26,JAPANESE YEN - CHICAGO MERCANTILE EXCHANGE,2024-07-30,65016,138476,     626,  -33022,303151,   -4032,-73460
27,JAPANESE YEN - CHICAGO MERCANTILE EXCHANGE,2024-07-23,64390,171498,   17034,  -26930,307183,     -22,-107108
28,JAPANESE YEN - CHICAGO MERCANTILE EXCHANGE,2024-07-16,47356,198428,    5835,  -25126,307205,  -41749,-151072
29,JAPANESE YEN - CHICAGO MERCANTILE EXCHANGE,2024-07-09,41521,223554,    4807,    2617,348954,    -863,-182033
30,JAPANESE YEN - CHICAGO MERCANTILE EXCHANGE,2024-07-02,36714,220937,    2138,   12461,349817,    9580,-184223
31,JAPANESE YEN - CHICAGO MERCANTILE EXCHANGE,2024-06-25,34576,208476,    5147,   31294,340237,   43120,-173900
32,JAPANESE YEN - CHICAGO MERCANTILE EXCHANGE,2024-06-18,29429,177182,   -1334,    7840,297117,  -22157,-147753
33,JAPANESE YEN - CHICAGO MERCANTILE EXCHANGE,2024-06-11,30763,169342,   -9664,   -3186,319274,   16265,-138579
34,JAPANESE YEN - CHICAGO MERCANTILE EXCHANGE,2024-06-04,40427,172528,   11862,  -12076,303009,  -22222,-132101
35,JAPANESE YEN - CHICAGO MERCANTILE EXCHANGE,2024-05-28,28565,184604,   -1049,   10623,325231,   23916,-156039
36,JAPANESE YEN - CHICAGO MERCANTILE EXCHANGE,2024-05-21,29614,173981,   -5689,   12496,301315,    3709,-144367
37,JAPANESE YEN - CHICAGO MERCANTILE EXCHANGE,2024-05-14,35303,161485,     313,   -8427,297606,   -2253,-126182
38,JAPANESE YEN - CHICAGO MERCANTILE EXCHANGE,2024-05-07,34990,169912,   -5445,  -38911,299859,  -34989,-134922
39,JAPANESE YEN - CHICAGO MERCANTILE EXCHANGE,2024-04-30,40435,208823,   -1991,  -13522,334848,   -1319,-168388
40,JAPANESE YEN - CHICAGO MERCANTILE EXCHANGE,2024-04-23,42426,222345,   -7037,    7263,336167,    5057,-179919
41,JAPANESE YEN - CHICAGO MERCANTILE EXCHANGE,2024-04-16,49463,215082,    2188,    5656,331110,    6631,-165619
42,JAPANESE YEN - CHICAGO MERCANTILE EXCHANGE,2024-04-09,47275,209426,   -7915,   11006,324479,    7670,-162151
43,JAPANESE YEN - CHICAGO MERCANTILE EXCHANGE,2024-04-02,55190,198420,   -4779,    9345,316809,   11108,-143230
44,JAPANESE YEN - CHICAGO MERCANTILE EXCHANGE,2024-03-26,59969,189075,   -6305,    6789,305701,    3201,-129106
45,JAPANESE YEN - CHICAGO MERCANTILE EXCHANGE,2024-03-19,66274,182286,   11351,   25041,302500,  -23175,-116012
46,JAPANESE YEN - CHICAGO MERCANTILE EXCHANGE,2024-03-12,54923,157245,     252,  -16269,325675,   11089,-102322
47,JAPANESE YEN - CHICAGO MERCANTILE EXCHANGE,2024-03-05,54671,173514,    3410,  -10452,314586,    4953,-118843
48,JAPANESE YEN - CHICAGO MERCANTILE EXCHANGE,2024-02-27,51261,183966,   -2601,    9326,309633,    4195,-132705
49,JAPANESE YEN - CHICAGO MERCANTILE EXCHANGE,2024-02-20,53862,174640,   -4692,    4550,305438,     846,-120778
50,JAPANESE YEN - CHICAGO MERCANTILE EXCHANGE,2024-02-13,58554,170090,    2908,   30214,304592,   45050,-111536
51,JAPANESE YEN - CHICAGO MERCANTILE EXCHANGE,2024-02-06,55646,139876,   10728,   14503,259542,   17513,-84230
52,JAPANESE YEN - CHICAGO MERCANTILE EXCHANGE,2024-01-30,44918,125373,   -7667,    2143,242029,   -1003,-80455
53,JAPANESE YEN - CHICAGO MERCANTILE EXCHANGE,2024-01-23,52585,123230,    8405,   22490,243032,   29723,-70645
54,JAPANESE YEN - CHICAGO MERCANTILE EXCHANGE,2024-01-16,44180,100740,    2816,    3427,213309,   13010,-56560
55,JAPANESE YEN - CHICAGO MERCANTILE EXCHANGE,2024-01-09,41364,97313,    7779,    6533,200299,   16257,-55949
56,JAPANESE YEN - CHICAGO MERCANTILE EXCHANGE,2024-01-02,33585,90780,   -3736,   -2109,184042,   -4498,-57195
57,JAPANESE YEN - CHICAGO MERCANTILE EXCHANGE,2023-12-26,37321,92889,    5587,   -3747,188540,    2600,-55568
58,JAPANESE YEN - CHICAGO MERCANTILE EXCHANGE,2023-12-19,31734,96636,    3508,  -12721,185940,  -71641,-64902
59,JAPANESE YEN - CHICAGO MERCANTILE EXCHANGE,2023-12-12,28226,109357,     -40,  -23865,257581,   -9901,-81131
60,JAPANESE YEN - CHICAGO MERCANTILE EXCHANGE,2023-12-05,28266,133222,   -2195,   -6476,267482,    6701,-104956
61,JAPANESE YEN - CHICAGO MERCANTILE EXCHANGE,2023-11-28,30461,139698,   -8775,   -4992,260781,   -4122,-109237
62,JAPANESE YEN - CHICAGO MERCANTILE EXCHANGE,2023-11-21,39236,144690,   11464,  -13331,264903,   -8860,-105454
63,JAPANESE YEN - CHICAGO MERCANTILE EXCHANGE,2023-11-14,27772,158021,     534,   26743,273763,   14065,-130249
64,JAPANESE YEN - CHICAGO MERCANTILE EXCHANGE,2023-11-07,27238,131278,  -10403,  -10211,259698,  -17574,-104040
65,JAPANESE YEN - CHICAGO MERCANTILE EXCHANGE,2023-10-31,37641,141489,    6677,   10896,277272,   16363,-103848
66,JAPANESE YEN - CHICAGO MERCANTILE EXCHANGE,2023-10-24,30964,130593,   -2175,   -5204,260909,   -6612,-99629
67,JAPANESE YEN - CHICAGO MERCANTILE EXCHANGE,2023-10-17,33139,135797,   -3641,    -459,267521,    7584,-102658
68,JAPANESE YEN - CHICAGO MERCANTILE EXCHANGE,2023-10-10,36780,136256,  -10764,  -25276,259937,  -22745,-99476
69,JAPANESE YEN - CHICAGO MERCANTILE EXCHANGE,2023-10-03,47544,161532,    1375,    5851,282682,   -3292,-113988
70,JAPANESE YEN - CHICAGO MERCANTILE EXCHANGE,2023-09-26,46169,155681,     432,    8325,285974,   20114,-109512
71,JAPANESE YEN - CHICAGO MERCANTILE EXCHANGE,2023-09-19,45737,147356,    7490,   10396,265860,   -4994,-101619
72,JAPANESE YEN - CHICAGO MERCANTILE EXCHANGE,2023-09-12,38247,136960,    1233,    2810,270854,    2510,-98713
73,JAPANESE YEN - CHICAGO MERCANTILE EXCHANGE,2023-09-05,37014,134150,   12224,   10887,268344,   22892,-97136
74,JAPANESE YEN - CHICAGO MERCANTILE EXCHANGE,2023-08-29,24790,123263,   -3890,    -740,245452,   -1471,-98473
75,JAPANESE YEN - CHICAGO MERCANTILE EXCHANGE,2023-08-22,28680,124003,   -6109,    8253,246923,   -1031,-95323
76,JAPANESE YEN - CHICAGO MERCANTILE EXCHANGE,2023-08-15,34789,115750,   11654,    9435,247954,   18105,-80961
77,JAPANESE YEN - CHICAGO MERCANTILE EXCHANGE,2023-08-08,23135,106315,   -3714,     250,229849,     834,-83180
78,JAPANESE YEN - CHICAGO MERCANTILE EXCHANGE,2023-08-01,26849,106065,   -3509,   -2045,229015,    5255,-79216
79,JAPANESE YEN - CHICAGO MERCANTILE EXCHANGE,2023-07-25,30358,108110,     582,  -11905,223760,   -7172,-77752
80,JAPANESE YEN - CHICAGO MERCANTILE EXCHANGE,2023-07-18,29776,120015,     -62,  -27005,230932,  -21417,-90239
81,JAPANESE YEN - CHICAGO MERCANTILE EXCHANGE,2023-07-11,29838,147020,  -11875,  -12613,252349,  -12717,-117182
82,JAPANESE YEN - CHICAGO MERCANTILE EXCHANGE,2023-07-03,41713,159633,    3695,    8745,265066,   13542,-117920
83,JAPANESE YEN - CHICAGO MERCANTILE EXCHANGE,2023-06-27,38018,150888,    5774,   10988,251524,   12968,-112870
84,JAPANESE YEN - CHICAGO MERCANTILE EXCHANGE,2023-06-20,32244,139900,   -4844,   -1164,238556,  -14010,-107656
85,JAPANESE YEN - CHICAGO MERCANTILE EXCHANGE,2023-06-13,37088,141064,    2937,    2096,252566,    7234,-103976
86,JAPANESE YEN - CHICAGO MERCANTILE EXCHANGE,2023-06-06,34151,138968,   -6585,    2039,245332,    2095,-104817
87,JAPANESE YEN - CHICAGO MERCANTILE EXCHANGE,2023-05-30,40736,136929,    3976,   19509,243237,   16837,-96193
88,JAPANESE YEN - CHICAGO MERCANTILE EXCHANGE,2023-05-23,36760,117420,    7266,   23135,226400,   25885,-80660
89,JAPANESE YEN - CHICAGO MERCANTILE EXCHANGE,2023-05-16,29494,94285,    7265,   11041,200515,    7941,-64791
90,JAPANESE YEN - CHICAGO MERCANTILE EXCHANGE,2023-05-09,22229,83244,   -5859,  -13168,192574,  -10422,-61015
91,JAPANESE YEN - CHICAGO MERCANTILE EXCHANGE,2023-05-02,28088,96412,   14408,   13988,202996,   18955,-68324
92,JAPANESE YEN - CHICAGO MERCANTILE EXCHANGE,2023-04-25,13680,82424,   -1981,    9894,184041,    6534,-68744
93,JAPANESE YEN - CHICAGO MERCANTILE EXCHANGE,2023-04-18,15661,72530,    3728,    3390,177507,     685,-56869
94,JAPANESE YEN - CHICAGO MERCANTILE EXCHANGE,2023-04-11,11933,69140,     410,     581,176822,   -2006,-57207
95,JAPANESE YEN - CHICAGO MERCANTILE EXCHANGE,2023-04-04,11523,68559,    1806,    4867,178828,    9355,-57036
96,JAPANESE YEN - CHICAGO MERCANTILE EXCHANGE,2023-03-28,9717,63692,    2462,   -9908,169473,     285,-53975
97,JAPANESE YEN - CHICAGO MERCANTILE EXCHANGE,2023-03-21,7255,73600,   -3793,  -12242,169188,  -10594,-66345
98,JAPANESE YEN - CHICAGO MERCANTILE EXCHANGE,2023-03-14,11048,85842,   -6093,   -6602,179782,  -31515,-74794
99,JAPANESE YEN - CHICAGO MERCANTILE EXCHANGE,2023-03-07,17141,92444,  -10562,    6063,211297,   11250,-75303
100,JAPANESE YEN - CHICAGO MERCANTILE EXCHANGE,2023-02-28,27703,86381,   -4783,   19866,200047,   13947,-58678
101,JAPANESE YEN - CHICAGO MERCANTILE EXCHANGE,2023-02-21,32486,66515,    9407,   15593,186100,   11145,-34029
102,JAPANESE YEN - CHICAGO MERCANTILE EXCHANGE,2023-02-14,23079,50922,    6523,    5277,174955,   10886,-27843
103,JAPANESE YEN - CHICAGO MERCANTILE EXCHANGE,2023-02-07,16556,45645,   -5994,    3035,164069,   -4471,-29089
104,JAPANESE YEN - CHICAGO MERCANTILE EXCHANGE,2023-01-31,22550,42610,   -5070,   -6645,168540,   -4781,-20060
105,JAPANESE YEN - CHICAGO MERCANTILE EXCHANGE,2023-01-24,27620,49255,   -1838,   -3164,173321,   -3541,-21635
106,JAPANESE YEN - CHICAGO MERCANTILE EXCHANGE,2023-01-17,29458,52419,    3063,   -9353,176862,    1117,-22961
107,JAPANESE YEN - CHICAGO MERCANTILE EXCHANGE,2023-01-10,26395,61772,    1018,  -10469,175745,    3155,-35377
108,JAPANESE YEN - CHICAGO MERCANTILE EXCHANGE,2023-01-03,25377,72241,   -4308,    4826,172590,    -546,-46864
109,JAPANESE YEN - CHICAGO MERCANTILE EXCHANGE,2022-12-27,29685,67415,   -4001,   -7152,173136,   -8898,-37730
110,JAPANESE YEN - CHICAGO MERCANTILE EXCHANGE,2022-12-20,33686,74567,   11396,    -911,182034,  -44930,-40881
111,JAPANESE YEN - CHICAGO MERCANTILE EXCHANGE,2022-12-13,22290,75478,   -1299,  -14107,226964,    3540,-53188
112,JAPANESE YEN - CHICAGO MERCANTILE EXCHANGE,2022-12-06,23589,89585,   -4536,   -5934,223424,   -4904,-65996
113,JAPANESE YEN - CHICAGO MERCANTILE EXCHANGE,2022-11-29,28125,95519,   -2675,    -131,228328,     893,-67394
114,JAPANESE YEN - CHICAGO MERCANTILE EXCHANGE,2022-11-22,30800,95650,   -2997,   -3989,227435,   -5911,-64850
115,JAPANESE YEN - CHICAGO MERCANTILE EXCHANGE,2022-11-15,33797,99639,   -3404,  -12820,233346,  -18032,-65842
116,JAPANESE YEN - CHICAGO MERCANTILE EXCHANGE,2022-11-08,37201,112459,   -3259,   -5621,251378,   -7528,-75258
117,JAPANESE YEN - CHICAGO MERCANTILE EXCHANGE,2022-11-01,40460,118080,    2881,  -22117,258906,  -13691,-77620
118,JAPANESE YEN - CHICAGO MERCANTILE EXCHANGE,2022-10-25,37579,140197,    6996,   15278,272597,    8332,-102618
119,JAPANESE YEN - CHICAGO MERCANTILE EXCHANGE,2022-10-18,30583,124919,     434,   17377,264265,   19258,-94336
120,JAPANESE YEN - CHICAGO MERCANTILE EXCHANGE,2022-10-11,30149,107542,    3187,   -1043,245007,    1718,-77393
121,JAPANESE YEN - CHICAGO MERCANTILE EXCHANGE,2022-10-04,26962,108585,    4256,    3323,243289,   -1366,-81623
122,JAPANESE YEN - CHICAGO MERCANTILE EXCHANGE,2022-09-27,22706,105262,  -12061,  -10785,244655,   -6237,-82556
123,JAPANESE YEN - CHICAGO MERCANTILE EXCHANGE,2022-09-20,34767,116047,   -4556,   -3968,250892,  -30824,-81280
124,JAPANESE YEN - CHICAGO MERCANTILE EXCHANGE,2022-09-13,39323,120015,  -16679,    5824,281716,     450,-80692
125,JAPANESE YEN - CHICAGO MERCANTILE EXCHANGE,2022-09-06,56002,114191,    1489,   18147,281266,   34236,-58189
126,JAPANESE YEN - CHICAGO MERCANTILE EXCHANGE,2022-08-30,54513,96044,   -2221,     503,247030,    4898,-41531
127,JAPANESE YEN - CHICAGO MERCANTILE EXCHANGE,2022-08-23,56734,95541,    5426,   15342,242132,   13435,-38807
128,JAPANESE YEN - CHICAGO MERCANTILE EXCHANGE,2022-08-16,51308,80199,   -1025,    2834,228697,    2863,-28891
129,JAPANESE YEN - CHICAGO MERCANTILE EXCHANGE,2022-08-09,52333,77365,    1900,  -15821,225834,  -10903,-25032
130,JAPANESE YEN - CHICAGO MERCANTILE EXCHANGE,2022-08-02,50433,93186,    6621,  -12107,236737,    7518,-42753
131,JAPANESE YEN - CHICAGO MERCANTILE EXCHANGE,2022-07-26,43812,105293,     932,    3188,229219,    -230,-61481
132,JAPANESE YEN - CHICAGO MERCANTILE EXCHANGE,2022-07-19,42880,102105,    7347,    6574,229449,    5910,-59225
133,JAPANESE YEN - CHICAGO MERCANTILE EXCHANGE,2022-07-12,35533,95531,   -3127,    2426,223539,    5867,-59998
134,JAPANESE YEN - CHICAGO MERCANTILE EXCHANGE,2022-07-05,38660,93105,    2198,    4073,217672,    3905,-54445
135,JAPANESE YEN - CHICAGO MERCANTILE EXCHANGE,2022-06-28,36462,89032,     598,   -5286,213767,   -4309,-52570
136,JAPANESE YEN - CHICAGO MERCANTILE EXCHANGE,2022-06-21,35864,94318,    3423,   -7878,218076,  -14437,-58454
137,JAPANESE YEN - CHICAGO MERCANTILE EXCHANGE,2022-06-14,32441,102196,   13975,   -7916,232513,  -33541,-69755
138,JAPANESE YEN - CHICAGO MERCANTILE EXCHANGE,2022-06-07,18466,110112,    3265,     472,266054,   26974,-91646
139,JAPANESE YEN - CHICAGO MERCANTILE EXCHANGE,2022-05-31,15201,109640,   -1366,   -6371,239080,    1824,-94439
140,JAPANESE YEN - CHICAGO MERCANTILE EXCHANGE,2022-05-24,16567,116011,    4454,    1589,237256,   -4052,-99444
141,JAPANESE YEN - CHICAGO MERCANTILE EXCHANGE,2022-05-17,12113,114422,     917,   -7228,241308,   -5970,-102309
142,JAPANESE YEN - CHICAGO MERCANTILE EXCHANGE,2022-05-10,11196,121650,   -7389,    2271,247278,   -7535,-110454
143,JAPANESE YEN - CHICAGO MERCANTILE EXCHANGE,2022-05-03,18585,119379,    4316,    9575,254813,   16818,-100794
144,JAPANESE YEN - CHICAGO MERCANTILE EXCHANGE,2022-04-26,14269,109804,    1546,  -10106,237995,  -13296,-95535
145,JAPANESE YEN - CHICAGO MERCANTILE EXCHANGE,2022-04-19,12723,119910,    2798,   -1842,251291,    5888,-107187
146,JAPANESE YEN - CHICAGO MERCANTILE EXCHANGE,2022-04-12,9925,121752,   -4658,    3340,245403,    3186,-111827
147,JAPANESE YEN - CHICAGO MERCANTILE EXCHANGE,2022-04-05,14583,118412,    -691,    1007,242217,    2519,-103829
148,JAPANESE YEN - CHICAGO MERCANTILE EXCHANGE,2022-03-29,15274,117405,  -21402,    2247,239698,   -8523,-102131
149,JAPANESE YEN - CHICAGO MERCANTILE EXCHANGE,2022-03-22,36676,115158,    2660,   18802,248221,   32737,-78482
150,JAPANESE YEN - CHICAGO MERCANTILE EXCHANGE,2022-03-15,34016,96356,   18468,   24952,215484,    6801,-62340
151,JAPANESE YEN - CHICAGO MERCANTILE EXCHANGE,2022-03-08,15548,71404,     883,  -11993,208683,      54,-55856
152,JAPANESE YEN - CHICAGO MERCANTILE EXCHANGE,2022-03-01,14665,83397,    3689,    9234,208629,   14460,-68732
153,JAPANESE YEN - CHICAGO MERCANTILE EXCHANGE,2022-02-22,10976,74163,     551,   -2424,194169,   -5256,-63187
154,JAPANESE YEN - CHICAGO MERCANTILE EXCHANGE,2022-02-15,10425,76587,   -5267,    1747,199425,    2947,-66162
155,JAPANESE YEN - CHICAGO MERCANTILE EXCHANGE,2022-02-08,15692,74840,    1182,    -310,196478,    2043,-59148
156,JAPANESE YEN - CHICAGO MERCANTILE EXCHANGE,2022-02-01,14510,75150,   -1356,   -8989,194435,   -3395,-60640
157,JAPANESE YEN - CHICAGO MERCANTILE EXCHANGE,2022-01-25,15866,84139,    7864,   -4742,197830,   -3990,-68273
158,JAPANESE YEN - CHICAGO MERCANTILE EXCHANGE,2022-01-18,8002,88881,  -14362,  -21008,201820,  -32185,-80879
159,JAPANESE YEN - CHICAGO MERCANTILE EXCHANGE,2022-01-11,22364,109889,  -18452,    6811,234005,     -63,-87525
160,JAPANESE YEN - CHICAGO MERCANTILE EXCHANGE,2022-01-04,40816,103078,    8341,   17501,234068,   30254,-62262
161,JAPANESE YEN - CHICAGO MERCANTILE EXCHANGE,2021-12-28,32475,85577,   10284,   11100,203814,   20071,-53102
162,JAPANESE YEN - CHICAGO MERCANTILE EXCHANGE,2021-12-21,22191,74477,    1960,     723,183743,    7159,-52286
163,JAPANESE YEN - CHICAGO MERCANTILE EXCHANGE,2021-12-14,20231,73754,    7083,   -2475,176584,  -29386,-53523
164,JAPANESE YEN - CHICAGO MERCANTILE EXCHANGE,2021-12-07,13148,76229,   -1437,  -17222,205970,  -10722,-63081
165,JAPANESE YEN - CHICAGO MERCANTILE EXCHANGE,2021-11-30,14585,93451,   -5700,  -24087,216692,  -35109,-78866
166,JAPANESE YEN - CHICAGO MERCANTILE EXCHANGE,2021-11-23,20285,117538,   -4350,    -223,251801,   -1096,-97253
167,JAPANESE YEN - CHICAGO MERCANTILE EXCHANGE,2021-11-16,24635,117761,    8195,   -4030,252897,    9810,-93126
168,JAPANESE YEN - CHICAGO MERCANTILE EXCHANGE,2021-11-09,16440,121791,   -3897,   -6170,243087,   -7971,-105351
169,JAPANESE YEN - CHICAGO MERCANTILE EXCHANGE,2021-11-02,20337,127961,  -11150,  -10562,251058,  -14196,-107624
170,JAPANESE YEN - CHICAGO MERCANTILE EXCHANGE,2021-10-26,31487,138523,   -4226,      76,265254,   -1496,-107036
171,JAPANESE YEN - CHICAGO MERCANTILE EXCHANGE,2021-10-19,35713,138447,     -97,   26003,266750,   23133,-102734
172,JAPANESE YEN - CHICAGO MERCANTILE EXCHANGE,2021-10-12,35810,112444,    4241,   17181,243617,   17238,-76634
173,JAPANESE YEN - CHICAGO MERCANTILE EXCHANGE,2021-10-05,31569,95263,   -3759,   -4825,226379,    6741,-63694
174,JAPANESE YEN - CHICAGO MERCANTILE EXCHANGE,2021-09-28,35328,100088,   12484,   21173,219638,   28425,-64760
175,JAPANESE YEN - CHICAGO MERCANTILE EXCHANGE,2021-09-21,22844,78915,    1116,   -3108,191213,    -875,-56071
176,JAPANESE YEN - CHICAGO MERCANTILE EXCHANGE,2021-09-14,21728,82023,   -7976,  -10006,192088,  -12347,-60295
177,JAPANESE YEN - CHICAGO MERCANTILE EXCHANGE,2021-09-07,29704,92029,     674,    -131,204435,   10436,-62325
178,JAPANESE YEN - CHICAGO MERCANTILE EXCHANGE,2021-08-31,29030,92160,    2267,   -1274,193999,    -478,-63130
179,JAPANESE YEN - CHICAGO MERCANTILE EXCHANGE,2021-08-24,26763,93434,    -769,    2694,194477,   -2018,-66671
180,JAPANESE YEN - CHICAGO MERCANTILE EXCHANGE,2021-08-17,27532,90740,   -9152,   -6601,196495,   -9636,-63208
181,JAPANESE YEN - CHICAGO MERCANTILE EXCHANGE,2021-08-10,36684,97341,    6275,   11742,206131,   16889,-60657
182,JAPANESE YEN - CHICAGO MERCANTILE EXCHANGE,2021-08-03,30409,85599,   -2566,   -7310,189242,   -6860,-55190
183,JAPANESE YEN - CHICAGO MERCANTILE EXCHANGE,2021-07-27,32975,92909,   -2499,    1704,196102,    3801,-59934
184,JAPANESE YEN - CHICAGO MERCANTILE EXCHANGE,2021-07-20,35474,91205,   -4966,   -5485,192301,  -11426,-55731
185,JAPANESE YEN - CHICAGO MERCANTILE EXCHANGE,2021-07-13,40440,96690,    8815,   -4071,203727,   -1614,-56250
186,JAPANESE YEN - CHICAGO MERCANTILE EXCHANGE,2021-07-06,31625,100761,    4245,    3486,205341,    9643,-69136
187,JAPANESE YEN - CHICAGO MERCANTILE EXCHANGE,2021-06-29,27380,97275,   -6738,    9295,195698,    5153,-69895
188,JAPANESE YEN - CHICAGO MERCANTILE EXCHANGE,2021-06-22,34118,87980,   11144,   18156,190545,   35186,-53862
189,JAPANESE YEN - CHICAGO MERCANTILE EXCHANGE,2021-06-15,22974,69824,   -4274,    5262,155359,   -6233,-46850
190,JAPANESE YEN - CHICAGO MERCANTILE EXCHANGE,2021-06-08,27248,64562,   -2214,  -12015,161592,    -499,-37314
191,JAPANESE YEN - CHICAGO MERCANTILE EXCHANGE,2021-06-01,29462,76577,    5299,    2258,162091,    8895,-47115
192,JAPANESE YEN - CHICAGO MERCANTILE EXCHANGE,2021-05-25,24163,74319,    -802,   -1594,153196,   -1531,-50156
193,JAPANESE YEN - CHICAGO MERCANTILE EXCHANGE,2021-05-18,24965,75913,   -5526,    3694,154727,    2323,-50948
194,JAPANESE YEN - CHICAGO MERCANTILE EXCHANGE,2021-05-11,30491,72219,    -717,    -481,152404,    -272,-41728
195,JAPANESE YEN - CHICAGO MERCANTILE EXCHANGE,2021-05-04,31208,72700,    1535,   -5482,152676,   -2218,-41492
196,JAPANESE YEN - CHICAGO MERCANTILE EXCHANGE,2021-04-27,29673,78182,    3056,   -8254,154894,   -7755,-48509
197,JAPANESE YEN - CHICAGO MERCANTILE EXCHANGE,2021-04-20,26617,86436,   -1065,     442,162649,   -2782,-59819
198,JAPANESE YEN - CHICAGO MERCANTILE EXCHANGE,2021-04-13,27682,85994,     888,    1211,165431,    1121,-58312
199,JAPANESE YEN - CHICAGO MERCANTILE EXCHANGE,2021-04-06,26794,84783,    2070,     578,164310,   -1781,-57989
200,JAPANESE YEN - CHICAGO MERCANTILE EXCHANGE,2021-03-30,24724,84205,   -2800,    3156,166091,    5510,-59481
201,JAPANESE YEN - CHICAGO MERCANTILE EXCHANGE,2021-03-23,27524,81049,    1521,   15678,160581,   14630,-53525
202,JAPANESE YEN - CHICAGO MERCANTILE EXCHANGE,2021-03-16,26003,65371,  -38024,    7858,145951,  -65396,-39368
203,JAPANESE YEN - CHICAGO MERCANTILE EXCHANGE,2021-03-09,64027,57513,    2768,   15524,211347,   22077,6514
204,JAPANESE YEN - CHICAGO MERCANTILE EXCHANGE,2021-03-02,61259,41989,   -5411,    3941,189270,    6023,19270
205,JAPANESE YEN - CHICAGO MERCANTILE EXCHANGE,2021-02-23,66670,38048,     -62,    8498,183247,   -4872,28622
206,JAPANESE YEN - CHICAGO MERCANTILE EXCHANGE,2021-02-16,66732,29550,    6013,    3449,188119,    4218,37182
207,JAPANESE YEN - CHICAGO MERCANTILE EXCHANGE,2021-02-09,60719,26101,   -8883,    1128,183901,   -7047,34618
208,JAPANESE YEN - CHICAGO MERCANTILE EXCHANGE,2021-02-02,69602,24973,    6139,    6502,190948,   -2874,44629
209,JAPANESE YEN - CHICAGO MERCANTILE EXCHANGE,2021-01-26,63463,18471,    -680,    4342,193822,    2282,44992
210,JAPANESE YEN - CHICAGO MERCANTILE EXCHANGE,2021-01-19,64143,14129,     286,     792,191540,     729,50014
211,JAPANESE YEN - CHICAGO MERCANTILE EXCHANGE,2021-01-12,63857,13337,   -5306,   -5636,190811,  -16152,50520
212,JAPANESE YEN - CHICAGO MERCANTILE EXCHANGE,2021-01-05,69163,18973,    5586,    2746,206963,   12509,50190
213,JAPANESE YEN - CHICAGO MERCANTILE EXCHANGE,2020-12-29,63577,16227,   -3393,   -4650,194454,   -2391,47350
214,JAPANESE YEN - CHICAGO MERCANTILE EXCHANGE,2020-12-21,66970,20877,    1594,    -536,196845,    3528,46093
215,JAPANESE YEN - CHICAGO MERCANTILE EXCHANGE,2020-12-15,65376,21413,    1791,    5994,193317,      -9,43963
216,JAPANESE YEN - CHICAGO MERCANTILE EXCHANGE,2020-12-08,63585,15419,    1136,     473,193326,    7453,48166
217,JAPANESE YEN - CHICAGO MERCANTILE EXCHANGE,2020-12-01,62449,14946,    7977,     716,185873,    6370,47503
218,JAPANESE YEN - CHICAGO MERCANTILE EXCHANGE,2020-11-24,54472,14230,   14159,    3584,179503,   14430,40242
219,JAPANESE YEN - CHICAGO MERCANTILE EXCHANGE,2020-11-17,40313,10646,  -15331,   -3104,165073,  -18445,29667
220,JAPANESE YEN - CHICAGO MERCANTILE EXCHANGE,2020-11-10,55644,13750,    4632,   -9164,183518,   -1233,41894
221,JAPANESE YEN - CHICAGO MERCANTILE EXCHANGE,2020-11-03,51012,22914,    4881,   -5324,184751,    7129,28098
222,JAPANESE YEN - CHICAGO MERCANTILE EXCHANGE,2020-10-27,46131,28238,    -393,   -4103,177622,   11531,17893
223,JAPANESE YEN - CHICAGO MERCANTILE EXCHANGE,2020-10-20,46524,32341,    -721,    5072,166091,     475,14183
224,JAPANESE YEN - CHICAGO MERCANTILE EXCHANGE,2020-10-13,47245,27269,    1466,    2592,165616,    2592,19976
225,JAPANESE YEN - CHICAGO MERCANTILE EXCHANGE,2020-10-06,45779,24677,   -1756,    1931,163024,    4726,21102
226,JAPANESE YEN - CHICAGO MERCANTILE EXCHANGE,2020-09-29,47535,22746,  -11498,   -6706,158298,  -10953,24789
227,JAPANESE YEN - CHICAGO MERCANTILE EXCHANGE,2020-09-22,59033,29452,    8673,    1981,169251,   20339,29581
228,JAPANESE YEN - CHICAGO MERCANTILE EXCHANGE,2020-09-15,50360,27471,    5510,    4363,148912,   -2634,22889
229,JAPANESE YEN - CHICAGO MERCANTILE EXCHANGE,2020-09-08,44850,23108,   -1804,    6058,151546,    5624,21742
230,JAPANESE YEN - CHICAGO MERCANTILE EXCHANGE,2020-09-01,46654,17050,    1676,   -4312,145922,   -1631,29604
231,JAPANESE YEN - CHICAGO MERCANTILE EXCHANGE,2020-08-25,44978,21362,    3261,     229,147553,     477,23616
232,JAPANESE YEN - CHICAGO MERCANTILE EXCHANGE,2020-08-18,41717,21133,   -6441,      -9,147076,   -3073,20584
233,JAPANESE YEN - CHICAGO MERCANTILE EXCHANGE,2020-08-11,48158,21142,   -3915,     498,150149,   -7819,27016
234,JAPANESE YEN - CHICAGO MERCANTILE EXCHANGE,2020-08-04,52073,20644,  -10851,  -13773,157968,  -12301,31429
235,JAPANESE YEN - CHICAGO MERCANTILE EXCHANGE,2020-07-28,62924,34417,   12070,    2870,170269,   27583,28507
236,JAPANESE YEN - CHICAGO MERCANTILE EXCHANGE,2020-07-21,50854,31547,    5743,    4762,142686,    7423,19307
237,JAPANESE YEN - CHICAGO MERCANTILE EXCHANGE,2020-07-14,45111,26785,    1068,    -446,135263,   -3050,18326
238,JAPANESE YEN - CHICAGO MERCANTILE EXCHANGE,2020-07-07,44043,27231,    1288,    8337,138313,     951,16812
239,JAPANESE YEN - CHICAGO MERCANTILE EXCHANGE,2020-06-30,42755,18894,   -7735,   -4138,137362,   -7187,23861
240,JAPANESE YEN - CHICAGO MERCANTILE EXCHANGE,2020-06-23,50490,23032,    7364,    2016,144549,   17262,27458
241,JAPANESE YEN - CHICAGO MERCANTILE EXCHANGE,2020-06-16,43126,21016,   -5736,  -10384,127287,  -27872,22110
242,JAPANESE YEN - CHICAGO MERCANTILE EXCHANGE,2020-06-09,48862,31400,  -13096,    2021,155159,   -3584,17462
243,JAPANESE YEN - CHICAGO MERCANTILE EXCHANGE,2020-06-02,61958,29379,    4085,    6113,158743,    1916,32579
244,JAPANESE YEN - CHICAGO MERCANTILE EXCHANGE,2020-05-26,57873,23266,    5835,   -1302,156827,    8852,34607
245,JAPANESE YEN - CHICAGO MERCANTILE EXCHANGE,2020-05-19,52038,24568,   -4269,   -3802,147975,   -5395,27470
246,JAPANESE YEN - CHICAGO MERCANTILE EXCHANGE,2020-05-12,56307,28370,    -327,   -1050,153370,    1328,27937
247,JAPANESE YEN - CHICAGO MERCANTILE EXCHANGE,2020-05-05,56634,29420,   -3328,    1784,152042,    8207,27214
248,JAPANESE YEN - CHICAGO MERCANTILE EXCHANGE,2020-04-28,59962,27636,    6232,     -68,143835,   15563,32326
249,JAPANESE YEN - CHICAGO MERCANTILE EXCHANGE,2020-04-21,53730,27704,    3867,     484,128272,    5343,26026
250,JAPANESE YEN - CHICAGO MERCANTILE EXCHANGE,2020-04-14,49863,27220,     614,     381,122929,    4334,22643
251,JAPANESE YEN - CHICAGO MERCANTILE EXCHANGE,2020-04-07,49249,26839,     805,   -3323,118595,   -1675,22410
252,JAPANESE YEN - CHICAGO MERCANTILE EXCHANGE,2020-03-31,48444,30162,   -8084,   -2503,120270,   -5324,18282
253,JAPANESE YEN - CHICAGO MERCANTILE EXCHANGE,2020-03-24,56528,32665,    -758,    8314,125594,    -175,23863
254,JAPANESE YEN - CHICAGO MERCANTILE EXCHANGE,2020-03-17,57286,24351,   -4446,  -29224,125769,  -33359,32935
255,JAPANESE YEN - CHICAGO MERCANTILE EXCHANGE,2020-03-10,61732,53575,   11134,  -39347,159128,  -39276,8157
256,JAPANESE YEN - CHICAGO MERCANTILE EXCHANGE,2020-03-03,50598,92922,   -3257,  -17322,198404,  -25500,-42324
257,JAPANESE YEN - CHICAGO MERCANTILE EXCHANGE,2020-02-25,53855,110244,   -4750,   24418,223904,   20273,-56389
258,JAPANESE YEN - CHICAGO MERCANTILE EXCHANGE,2020-02-18,58605,85826,    3800,    4833,203631,    9809,-27221
259,JAPANESE YEN - CHICAGO MERCANTILE EXCHANGE,2020-02-11,54805,80993,   -2867,    1423,193822,    3743,-26188
260,JAPANESE YEN - CHICAGO MERCANTILE EXCHANGE,2020-02-04,57672,79570,   11996,   -2131,190079,    5160,-21898
261,JAPANESE YEN - CHICAGO MERCANTILE EXCHANGE,2020-01-28,45676,81701,   -4920,  -13596,184919,  -18660,-36025
262,JAPANESE YEN - CHICAGO MERCANTILE EXCHANGE,2020-01-21,50596,95297,     876,   14147,203579,   19716,-44701
263,JAPANESE YEN - CHICAGO MERCANTILE EXCHANGE,2020-01-14,49720,81150,    1874,   21056,183863,   21769,-31430
264,JAPANESE YEN - CHICAGO MERCANTILE EXCHANGE,2020-01-07,47846,60094,    4178,   -8876,162094,  -12872,-12248
265,JAPANESE YEN - CHICAGO MERCANTILE EXCHANGE,2019-12-31,43668,68970,    3076,   -5164,174966,    1824,-25302
266,JAPANESE YEN - CHICAGO MERCANTILE EXCHANGE,2019-12-24,40592,74134,   -2826,  -11346,173142,   -5387,-33542
267,JAPANESE YEN - CHICAGO MERCANTILE EXCHANGE,2019-12-17,43418,85480,    1575,     -45,178529,  -20171,-42062
268,JAPANESE YEN - CHICAGO MERCANTILE EXCHANGE,2019-12-10,41843,85525,   -6469,  -10610,198700,  -15523,-43682
269,JAPANESE YEN - CHICAGO MERCANTILE EXCHANGE,2019-12-03,48312,96135,    -966,    7266,214223,   17329,-47823
270,JAPANESE YEN - CHICAGO MERCANTILE EXCHANGE,2019-11-26,49278,88869,    3855,    8415,196894,   14449,-39591
271,JAPANESE YEN - CHICAGO MERCANTILE EXCHANGE,2019-11-19,45423,80454,    1459,    1493,182445,   -1035,-35031
272,JAPANESE YEN - CHICAGO MERCANTILE EXCHANGE,2019-11-12,43964,78961,     -32,    8360,183480,    6374,-34997
273,JAPANESE YEN - CHICAGO MERCANTILE EXCHANGE,2019-11-05,43996,70601,    4811,   11718,177106,   13620,-26605
274,JAPANESE YEN - CHICAGO MERCANTILE EXCHANGE,2019-10-29,39185,58883,   -2371,    -838,163486,    4236,-19698
275,JAPANESE YEN - CHICAGO MERCANTILE EXCHANGE,2019-10-22,41556,59721,   -4860,    6664,159250,    1543,-18165
276,JAPANESE YEN - CHICAGO MERCANTILE EXCHANGE,2019-10-15,46416,53057,   -6387,   11266,157707,    7688,-6641
277,JAPANESE YEN - CHICAGO MERCANTILE EXCHANGE,2019-10-08,52803,41791,   -5090,   -2185,150019,   -1841,11012
278,JAPANESE YEN - CHICAGO MERCANTILE EXCHANGE,2019-10-01,57893,43976,   12134,   11000,151860,    9834,13917
279,JAPANESE YEN - CHICAGO MERCANTILE EXCHANGE,2019-09-24,45759,32976,   -5083,    5996,142026,   11086,12783
280,JAPANESE YEN - CHICAGO MERCANTILE EXCHANGE,2019-09-17,50842,26980,   -5737,    2992,130940,  -20457,23862
281,JAPANESE YEN - CHICAGO MERCANTILE EXCHANGE,2019-09-10,56579,23988,    -643,   -5552,151397,   -6391,32591
282,JAPANESE YEN - CHICAGO MERCANTILE EXCHANGE,2019-09-03,57222,29540,   -2573,    3352,157788,     -74,27682
283,JAPANESE YEN - CHICAGO MERCANTILE EXCHANGE,2019-08-27,59795,26188,    9811,    7358,157862,    3200,33607
284,JAPANESE YEN - CHICAGO MERCANTILE EXCHANGE,2019-08-20,49984,18830,   -1780,   -8192,154662,   -5609,31154
285,JAPANESE YEN - CHICAGO MERCANTILE EXCHANGE,2019-08-13,51764,27022,    5539,   -8642,160271,    6933,24742
286,JAPANESE YEN - CHICAGO MERCANTILE EXCHANGE,2019-08-06,46225,35664,    9197,   -5582,153338,   14496,10561
287,JAPANESE YEN - CHICAGO MERCANTILE EXCHANGE,2019-07-30,37028,41246,    2386,   -2773,138842,    2597,-4218
288,JAPANESE YEN - CHICAGO MERCANTILE EXCHANGE,2019-07-23,34642,44019,    1737,    -266,136245,    5941,-9377
289,JAPANESE YEN - CHICAGO MERCANTILE EXCHANGE,2019-07-16,32905,44285,   -2441,    5288,130304,   -5433,-11380
290,JAPANESE YEN - CHICAGO MERCANTILE EXCHANGE,2019-07-09,35346,38997,    1148,    3572,135737,   -3618,-3651
291,JAPANESE YEN - CHICAGO MERCANTILE EXCHANGE,2019-07-02,34198,35425,    3108,   -5812,139355,     -84,-1227
292,JAPANESE YEN - CHICAGO MERCANTILE EXCHANGE,2019-06-25,31090,41237,    2921,   -3497,139439,   15810,-10147
293,JAPANESE YEN - CHICAGO MERCANTILE EXCHANGE,2019-06-18,28169,44734,    7383,  -21217,123629,  -45758,-16565
294,JAPANESE YEN - CHICAGO MERCANTILE EXCHANGE,2019-06-11,20786,65951,   -6651,   -5875,169387,    1577,-45165
295,JAPANESE YEN - CHICAGO MERCANTILE EXCHANGE,2019-06-04,27437,71826,    1634,   -9554,167810,   -1980,-44389
296,JAPANESE YEN - CHICAGO MERCANTILE EXCHANGE,2019-05-28,25803,81380,   -1737,   -1352,169790,   -1044,-55577
297,JAPANESE YEN - CHICAGO MERCANTILE EXCHANGE,2019-05-21,27540,82732,   -8375,  -14763,170834,   -9739,-55192
298,JAPANESE YEN - CHICAGO MERCANTILE EXCHANGE,2019-05-14,35915,97495,   10046,  -20091,180573,  -20889,-61580
299,JAPANESE YEN - CHICAGO MERCANTILE EXCHANGE,2019-05-07,25869,117586,    5291,   -2591,201462,   -1861,-91717
300,JAPANESE YEN - CHICAGO MERCANTILE EXCHANGE,2019-04-30,20578,120177,   -7543,   -2358,203323,   -3993,-99599
301,JAPANESE YEN - CHICAGO MERCANTILE EXCHANGE,2019-04-23,28121,122535,   -3686,    3622,207316,    7298,-94414
302,JAPANESE YEN - CHICAGO MERCANTILE EXCHANGE,2019-04-16,31807,118913,   11893,   27479,200018,   34282,-87106
303,JAPANESE YEN - CHICAGO MERCANTILE EXCHANGE,2019-04-09,19914,91434,    -548,    8231,165736,    8898,-71520
304,JAPANESE YEN - CHICAGO MERCANTILE EXCHANGE,2019-04-02,20462,83203,    2139,    2759,156838,    -307,-62741
305,JAPANESE YEN - CHICAGO MERCANTILE EXCHANGE,2019-03-26,18323,80444,   -1758,    1142,157145,    -929,-62121
306,JAPANESE YEN - CHICAGO MERCANTILE EXCHANGE,2019-03-19,20081,79302,   -2063,   -1623,158074,  -38692,-59221
307,JAPANESE YEN - CHICAGO MERCANTILE EXCHANGE,2019-03-12,22144,80925,  -11277,   -3802,196766,  -10317,-58781
308,JAPANESE YEN - CHICAGO MERCANTILE EXCHANGE,2019-03-05,33421,84727,    6056,   17708,207083,   20925,-51306
309,JAPANESE YEN - CHICAGO MERCANTILE EXCHANGE,2019-02-26,27365,67019,    2521,    4714,186158,    2135,-39654
310,JAPANESE YEN - CHICAGO MERCANTILE EXCHANGE,2019-02-19,24844,62305,     303,    7022,184023,   -1702,-37461
311,JAPANESE YEN - CHICAGO MERCANTILE EXCHANGE,2019-02-12,24541,55283,    3789,    3121,185725,   -7064,-30742
312,JAPANESE YEN - CHICAGO MERCANTILE EXCHANGE,2019-02-05,20752,52162,   -6249,   -8184,192789,  -12027,-31410
313,JAPANESE YEN - CHICAGO MERCANTILE EXCHANGE,2019-01-29,27001,60346,   -1402,   -7724,204816,   -7747,-33345
314,JAPANESE YEN - CHICAGO MERCANTILE EXCHANGE,2019-01-22,28403,68070,  -10283,  -17037,212563,  -16732,-39667
315,JAPANESE YEN - CHICAGO MERCANTILE EXCHANGE,2019-01-15,38686,85107,   -4041,  -18934,229295,   -1229,-46421
316,JAPANESE YEN - CHICAGO MERCANTILE EXCHANGE,2019-01-08,42727,104041,   10015,  -17294,230524,   14300,-61314
317,JAPANESE YEN - CHICAGO MERCANTILE EXCHANGE,2018-12-31,32712,121335,    -569,  -11035,216224,   -8234,-88623
318,JAPANESE YEN - CHICAGO MERCANTILE EXCHANGE,2018-12-24,33281,132370,    6324,    2642,224458,    9590,-99089
319,JAPANESE YEN - CHICAGO MERCANTILE EXCHANGE,2018-12-18,26957,129728,    1462,    6627,214868,    1813,-102771
320,JAPANESE YEN - CHICAGO MERCANTILE EXCHANGE,2018-12-11,25495,123101,   -7222,  -19382,213055,  -13780,-97606
321,JAPANESE YEN - CHICAGO MERCANTILE EXCHANGE,2018-12-04,32717,142483,   -3100,    2342,226835,   -4876,-109766
322,JAPANESE YEN - CHICAGO MERCANTILE EXCHANGE,2018-11-27,35817,140141,    2355,    6614,231711,    8567,-104324
323,JAPANESE YEN - CHICAGO MERCANTILE EXCHANGE,2018-11-20,33462,133527,   -6730,   -8959,223144,   -8586,-100065
324,JAPANESE YEN - CHICAGO MERCANTILE EXCHANGE,2018-11-13,40192,142486,    7132,   20304,231730,   22277,-102294
325,JAPANESE YEN - CHICAGO MERCANTILE EXCHANGE,2018-11-06,33060,122182,    4206,    1708,209453,    6340,-89122
326,JAPANESE YEN - CHICAGO MERCANTILE EXCHANGE,2018-10-30,28854,120474,   -1068,   -2252,203113,   -2530,-91620
327,JAPANESE YEN - CHICAGO MERCANTILE EXCHANGE,2018-10-23,29922,122726,    -174,   -7991,205643,   -5567,-92804
328,JAPANESE YEN - CHICAGO MERCANTILE EXCHANGE,2018-10-16,30096,130717,  -16938,  -31518,211210,  -42164,-100621
329,JAPANESE YEN - CHICAGO MERCANTILE EXCHANGE,2018-10-09,47034,162235,   -9040,   -7885,253374,    1097,-115201
330,JAPANESE YEN - CHICAGO MERCANTILE EXCHANGE,2018-10-02,56074,170120,    8821,   38148,252277,   36901,-114046
331,JAPANESE YEN - CHICAGO MERCANTILE EXCHANGE,2018-09-25,47253,131972,   -2499,   18465,215376,   15155,-84719
332,JAPANESE YEN - CHICAGO MERCANTILE EXCHANGE,2018-09-18,49752,113507,    1695,   11564,200221,    6793,-63755
333,JAPANESE YEN - CHICAGO MERCANTILE EXCHANGE,2018-09-11,48057,101943,     485,    2439,193428,    8081,-53886
334,JAPANESE YEN - CHICAGO MERCANTILE EXCHANGE,2018-09-04,47572,99504,   -2658,    3233,185347,     265,-51932
335,JAPANESE YEN - CHICAGO MERCANTILE EXCHANGE,2018-08-28,50230,96271,   -3886,   -5251,185082,   -4616,-46041
336,JAPANESE YEN - CHICAGO MERCANTILE EXCHANGE,2018-08-21,54116,101522,    4747,   -6215,189698,    3864,-47406
337,JAPANESE YEN - CHICAGO MERCANTILE EXCHANGE,2018-08-14,49369,107737,    3233,   -1206,185834,   -2068,-58368
338,JAPANESE YEN - CHICAGO MERCANTILE EXCHANGE,2018-08-07,46136,108943,   -1880,   -7530,187902,   -9664,-62807
339,JAPANESE YEN - CHICAGO MERCANTILE EXCHANGE,2018-07-31,48016,116473,   -1977,   -7289,197566,   -2861,-68457
340,JAPANESE YEN - CHICAGO MERCANTILE EXCHANGE,2018-07-24,49993,123762,  -27028,  -11909,200427,  -14986,-73769
341,JAPANESE YEN - CHICAGO MERCANTILE EXCHANGE,2018-07-17,77021,135671,   16458,   35276,215413,   33347,-58650
342,JAPANESE YEN - CHICAGO MERCANTILE EXCHANGE,2018-07-10,60563,100395,   10573,   11675,182066,   13706,-39832
343,JAPANESE YEN - CHICAGO MERCANTILE EXCHANGE,2018-07-03,49990,88720,    5560,   10069,168360,   14794,-38730
344,JAPANESE YEN - CHICAGO MERCANTILE EXCHANGE,2018-06-26,44430,78651,   -2135,   -3476,153566,   -1075,-34221
345,JAPANESE YEN - CHICAGO MERCANTILE EXCHANGE,2018-06-19,46565,82127,  -14044,   26570,154641,  -12236,-35562
346,JAPANESE YEN - CHICAGO MERCANTILE EXCHANGE,2018-06-12,60609,55557,    8549,      60,166877,   20429,5052
347,JAPANESE YEN - CHICAGO MERCANTILE EXCHANGE,2018-06-05,52060,55497,  -11122,  -15721,146448,  -24891,-3437
348,JAPANESE YEN - CHICAGO MERCANTILE EXCHANGE,2018-05-29,63182,71218,  -10654,   -5385,171339,   -3977,-8036
349,JAPANESE YEN - CHICAGO MERCANTILE EXCHANGE,2018-05-22,73836,76603,    8910,   15357,175316,   11905,-2767
350,JAPANESE YEN - CHICAGO MERCANTILE EXCHANGE,2018-05-15,64926,61246,   13114,    3972,163411,    5835,3680
351,JAPANESE YEN - CHICAGO MERCANTILE EXCHANGE,2018-05-08,51812,57274,   -5537,   -1480,157576,   -2761,-5462
352,JAPANESE YEN - CHICAGO MERCANTILE EXCHANGE,2018-05-01,57349,58754,   -1904,      84,160337,    5100,-1405
353,JAPANESE YEN - CHICAGO MERCANTILE EXCHANGE,2018-04-24,59253,58670,    9820,   11828,155237,    7918,583
354,JAPANESE YEN - CHICAGO MERCANTILE EXCHANGE,2018-04-17,49433,46842,    -422,    -252,147319,   -3883,2591
355,JAPANESE YEN - CHICAGO MERCANTILE EXCHANGE,2018-04-10,49855,47094,    1802,    2613,151202,    2384,2761
356,JAPANESE YEN - CHICAGO MERCANTILE EXCHANGE,2018-04-03,48053,44481,   -8491,  -15731,148818,  -13220,3572
357,JAPANESE YEN - CHICAGO MERCANTILE EXCHANGE,2018-03-27,56544,60212,    8642,   -9689,162038,    1788,-3668
358,JAPANESE YEN - CHICAGO MERCANTILE EXCHANGE,2018-03-20,47902,69901,    3606,  -53934,160250, -119421,-21999
359,JAPANESE YEN - CHICAGO MERCANTILE EXCHANGE,2018-03-13,44296,123835,   -5761,  -13067,279671,    2344,-79539
360,JAPANESE YEN - CHICAGO MERCANTILE EXCHANGE,2018-03-06,50057,136902,    5518,   -4288,277327,   14261,-86845
361,JAPANESE YEN - CHICAGO MERCANTILE EXCHANGE,2018-02-27,44539,141190,   -1095,  -12782,263066,   -8205,-96651
362,JAPANESE YEN - CHICAGO MERCANTILE EXCHANGE,2018-02-20,45634,153972,    3335,   -3836,271271,   11101,-108338
363,JAPANESE YEN - CHICAGO MERCANTILE EXCHANGE,2018-02-13,42299,157808,    3191,    5824,260170,   10692,-115509
364,JAPANESE YEN - CHICAGO MERCANTILE EXCHANGE,2018-02-06,39108,151984,   -8720,  -10540,249478,  -10759,-112876
365,JAPANESE YEN - CHICAGO MERCANTILE EXCHANGE,2018-01-30,47828,162524,   10568,    2394,260237,   19101,-114696
366,JAPANESE YEN - CHICAGO MERCANTILE EXCHANGE,2018-01-23,37260,160130,    -892,    2628,241136,    4831,-122870
367,JAPANESE YEN - CHICAGO MERCANTILE EXCHANGE,2018-01-16,38152,157502,     776,   -5410,236305,    3161,-119350
368,JAPANESE YEN - CHICAGO MERCANTILE EXCHANGE,2018-01-09,37376,162912,   -2216,    1554,233144,    2580,-125536
369,JAPANESE YEN - CHICAGO MERCANTILE EXCHANGE,2018-01-02,39592,161358,   -4677,    1003,230564,   -1864,-121766
370,JAPANESE YEN - CHICAGO MERCANTILE EXCHANGE,2017-12-26,44269,160355,    7395,    9108,232428,    9004,-116086
371,JAPANESE YEN - CHICAGO MERCANTILE EXCHANGE,2017-12-19,36874,151247,    5127,    5377,223424,  -27157,-114373
372,JAPANESE YEN - CHICAGO MERCANTILE EXCHANGE,2017-12-12,31747,145870,   -3019,   -3163,250581,   12504,-114123
373,JAPANESE YEN - CHICAGO MERCANTILE EXCHANGE,2017-12-05,34766,149033,   -5027,   -1400,238077,   -6459,-114267
374,JAPANESE YEN - CHICAGO MERCANTILE EXCHANGE,2017-11-28,39793,150433,   -4589,  -16551,244536,  -16483,-110640
375,JAPANESE YEN - CHICAGO MERCANTILE EXCHANGE,2017-11-21,44382,166984,   -4965,  -18362,261019,  -22609,-122602
376,JAPANESE YEN - CHICAGO MERCANTILE EXCHANGE,2017-11-14,49347,185346,   -4989,    3162,283628,   -4308,-135999
377,JAPANESE YEN - CHICAGO MERCANTILE EXCHANGE,2017-11-07,54336,182184,    -249,    8730,287936,   10230,-127848
378,JAPANESE YEN - CHICAGO MERCANTILE EXCHANGE,2017-10-31,54585,173454,   -5492,   -3480,277706,   -4524,-118869
379,JAPANESE YEN - CHICAGO MERCANTILE EXCHANGE,2017-10-24,60077,176934,    5067,   20638,282230,   25143,-116857
380,JAPANESE YEN - CHICAGO MERCANTILE EXCHANGE,2017-10-17,55010,156296,    3355,    3222,257087,    2963,-101286
381,JAPANESE YEN - CHICAGO MERCANTILE EXCHANGE,2017-10-10,51655,153074,   -7115,    9661,254124,    7235,-101419
382,JAPANESE YEN - CHICAGO MERCANTILE EXCHANGE,2017-10-03,58770,143413,   15807,   29103,246889,   39792,-84643
383,JAPANESE YEN - CHICAGO MERCANTILE EXCHANGE,2017-09-26,42963,114310,     528,   20553,207097,   21745,-71347
384,JAPANESE YEN - CHICAGO MERCANTILE EXCHANGE,2017-09-19,42435,93757,    1793,   -4182,185352,  -15092,-51322
385,JAPANESE YEN - CHICAGO MERCANTILE EXCHANGE,2017-09-12,40642,97939,   -6643,  -22291,200444,  -12756,-57297
386,JAPANESE YEN - CHICAGO MERCANTILE EXCHANGE,2017-09-05,47285,120230,    3396,    7817,213200,    3310,-72945
387,JAPANESE YEN - CHICAGO MERCANTILE EXCHANGE,2017-08-29,43889,112413,   -1273,   -6835,209890,   -5567,-68524
388,JAPANESE YEN - CHICAGO MERCANTILE EXCHANGE,2017-08-22,45162,119248,    1854,   -1552,215457,     367,-74086
389,JAPANESE YEN - CHICAGO MERCANTILE EXCHANGE,2017-08-15,43308,120800,    3498,  -14823,215090,  -17737,-77492
390,JAPANESE YEN - CHICAGO MERCANTILE EXCHANGE,2017-08-08,39810,135623,    3365,  -13018,232827,  -10049,-95813
391,JAPANESE YEN - CHICAGO MERCANTILE EXCHANGE,2017-08-01,36445,148641,    8427,    -866,242876,    7736,-112196
392,JAPANESE YEN - CHICAGO MERCANTILE EXCHANGE,2017-07-25,28018,149507,   -9401,  -14831,235140,  -14931,-121489
393,JAPANESE YEN - CHICAGO MERCANTILE EXCHANGE,2017-07-18,37419,164338,   -3359,   11435,250071,   10285,-126919
394,JAPANESE YEN - CHICAGO MERCANTILE EXCHANGE,2017-07-11,40778,152903,   -2870,   34219,239786,   32189,-112125
395,JAPANESE YEN - CHICAGO MERCANTILE EXCHANGE,2017-07-03,43648,118684,    5394,   19080,207597,   23892,-75036
396,JAPANESE YEN - CHICAGO MERCANTILE EXCHANGE,2017-06-27,38254,99604,   -1244,   10147,183705,   11865,-61350
397,JAPANESE YEN - CHICAGO MERCANTILE EXCHANGE,2017-06-20,39498,89457,    5338,    4744,171840,  -38777,-49959
398,JAPANESE YEN - CHICAGO MERCANTILE EXCHANGE,2017-06-13,34160,84713,   -5576,  -10050,210617,  -14932,-50553
399,JAPANESE YEN - CHICAGO MERCANTILE EXCHANGE,2017-06-06,39736,94763,   -3668,    -916,225549,   11822,-55027
400,JAPANESE YEN - CHICAGO MERCANTILE EXCHANGE,2017-05-30,43404,95679,    1484,    2103,213727,    2429,-52275
401,JAPANESE YEN - CHICAGO MERCANTILE EXCHANGE,2017-05-23,41920,93576,     -43,   -8395,211298,  -11212,-51656
402,JAPANESE YEN - CHICAGO MERCANTILE EXCHANGE,2017-05-16,41963,101971,    -672,   23029,222510,   19370,-60008
403,JAPANESE YEN - CHICAGO MERCANTILE EXCHANGE,2017-05-09,42635,78942,    5116,   10940,203140,    6295,-36307
404,JAPANESE YEN - CHICAGO MERCANTILE EXCHANGE,2017-05-02,37519,68002,  -11019,   -7405,196845,   -7334,-30483
405,JAPANESE YEN - CHICAGO MERCANTILE EXCHANGE,2017-04-25,48538,75407,    2777,    -817,204179,     562,-26869
406,JAPANESE YEN - CHICAGO MERCANTILE EXCHANGE,2017-04-18,45761,76224,    2445,   -1856,203617,    5236,-30463
407,JAPANESE YEN - CHICAGO MERCANTILE EXCHANGE,2017-04-11,43316,78080,    2003,   -9033,198381,    4013,-34764
408,JAPANESE YEN - CHICAGO MERCANTILE EXCHANGE,2017-04-04,41313,87113,   -1573,   -8954,194368,   -3174,-45800
409,JAPANESE YEN - CHICAGO MERCANTILE EXCHANGE,2017-03-28,42886,96067,    7847,   -5959,197542,    5916,-53181
410,JAPANESE YEN - CHICAGO MERCANTILE EXCHANGE,2017-03-21,35039,102026,    -524,   -4834,191626,  -11021,-66987
411,JAPANESE YEN - CHICAGO MERCANTILE EXCHANGE,2017-03-14,35563,106860,   -3640,   12957,202647,  -15335,-71297
412,JAPANESE YEN - CHICAGO MERCANTILE EXCHANGE,2017-03-07,39203,93903,   10191,   14874,217982,   13380,-54700
413,JAPANESE YEN - CHICAGO MERCANTILE EXCHANGE,2017-02-28,29012,79029,    -942,   -1087,204602,    -621,-50017
414,JAPANESE YEN - CHICAGO MERCANTILE EXCHANGE,2017-02-21,29954,80116,    2253,    1131,205223,     946,-50162
415,JAPANESE YEN - CHICAGO MERCANTILE EXCHANGE,2017-02-14,27701,78985,    1827,   -1949,204277,    2645,-51284
416,JAPANESE YEN - CHICAGO MERCANTILE EXCHANGE,2017-02-07,25874,80934,   -6342,   -9613,201632,   -2862,-55060
417,JAPANESE YEN - CHICAGO MERCANTILE EXCHANGE,2017-01-31,32216,90547,    5089,   -3420,204494,    7729,-58331
418,JAPANESE YEN - CHICAGO MERCANTILE EXCHANGE,2017-01-24,27127,93967,   -1433,  -12423,196765,  -14987,-66840
419,JAPANESE YEN - CHICAGO MERCANTILE EXCHANGE,2017-01-17,28560,106390,    2519,     510,211752,    2264,-77830
420,JAPANESE YEN - CHICAGO MERCANTILE EXCHANGE,2017-01-10,26041,105880,  -11921,  -18846,209488,  -10632,-79839
421,JAPANESE YEN - CHICAGO MERCANTILE EXCHANGE,2017-01-03,37962,124726,   -2603,   -2848,220120,     777,-86764
422,JAPANESE YEN - CHICAGO MERCANTILE EXCHANGE,2016-12-27,40565,127574,  -23635,  -12075,219343,   -1092,-87009
423,JAPANESE YEN - CHICAGO MERCANTILE EXCHANGE,2016-12-20,64200,139649,    1768,   13788,220435,  -64839,-75449
424,JAPANESE YEN - CHICAGO MERCANTILE EXCHANGE,2016-12-13,62432,125861,  -11935,   17557,285274,   49359,-63429
425,JAPANESE YEN - CHICAGO MERCANTILE EXCHANGE,2016-12-06,74367,108304,    2243,   35911,235915,   33744,-33937
426,JAPANESE YEN - CHICAGO MERCANTILE EXCHANGE,2016-11-29,72124,72393,     941,   12110,202171,   14487,-269
427,JAPANESE YEN - CHICAGO MERCANTILE EXCHANGE,2016-11-22,71183,60283,    4098,   13874,187684,   16717,10900
428,JAPANESE YEN - CHICAGO MERCANTILE EXCHANGE,2016-11-15,67085,46409,   -5534,    5746,170967,    6639,20676
429,JAPANESE YEN - CHICAGO MERCANTILE EXCHANGE,2016-11-08,72619,40663,   -8391,    2813,164328,    -796,31956
430,JAPANESE YEN - CHICAGO MERCANTILE EXCHANGE,2016-11-01,81010,37850,   -1375,      60,165124,    2084,43160
431,JAPANESE YEN - CHICAGO MERCANTILE EXCHANGE,2016-10-25,82385,37790,    7419,    -185,163040,    6433,44595
432,JAPANESE YEN - CHICAGO MERCANTILE EXCHANGE,2016-10-18,74966,37975,   -4313,    4605,156607,    6213,36991
433,JAPANESE YEN - CHICAGO MERCANTILE EXCHANGE,2016-10-11,79279,33370,  -22707,      79,150394,   -7180,45909
434,JAPANESE YEN - CHICAGO MERCANTILE EXCHANGE,2016-10-04,101986,33291,    4554,    4751,157574,    2404,68695
435,JAPANESE YEN - CHICAGO MERCANTILE EXCHANGE,2016-09-27,97432,28540,   12315,    2208,155170,   14432,68892
436,JAPANESE YEN - CHICAGO MERCANTILE EXCHANGE,2016-09-20,85117,26332,   -1023,   -2962,140738,  -26602,58785
437,JAPANESE YEN - CHICAGO MERCANTILE EXCHANGE,2016-09-13,86140,29294,    2172,    -185,167340,    7998,56846
438,JAPANESE YEN - CHICAGO MERCANTILE EXCHANGE,2016-09-06,83968,29479,   -7602,    1570,159342,   -4987,54489
439,JAPANESE YEN - CHICAGO MERCANTILE EXCHANGE,2016-08-30,91570,27909,    1183,   -2162,164329,    -427,63661
440,JAPANESE YEN - CHICAGO MERCANTILE EXCHANGE,2016-08-23,90387,30071,    2114,   -2196,164756,   -1149,60316
441,JAPANESE YEN - CHICAGO MERCANTILE EXCHANGE,2016-08-16,88273,32267,    1554,   -5621,165905,   -1106,56006
442,JAPANESE YEN - CHICAGO MERCANTILE EXCHANGE,2016-08-09,86719,37888,   10144,    3013,167011,   10315,48831
443,JAPANESE YEN - CHICAGO MERCANTILE EXCHANGE,2016-08-02,76575,34875,    2501,   -4241,156696,   -3173,41700
444,JAPANESE YEN - CHICAGO MERCANTILE EXCHANGE,2016-07-26,74074,39116,   -5790,   -1395,159869,    1503,34958
445,JAPANESE YEN - CHICAGO MERCANTILE EXCHANGE,2016-07-19,79864,40511,   -5500,    2692,158366,   -2896,39353
446,JAPANESE YEN - CHICAGO MERCANTILE EXCHANGE,2016-07-12,85364,37819,   -1673,   14350,161262,   10845,47545
447,JAPANESE YEN - CHICAGO MERCANTILE EXCHANGE,2016-07-05,87037,23469,    1544,   -2274,150417,    7300,63568
448,JAPANESE YEN - CHICAGO MERCANTILE EXCHANGE,2016-06-28,85493,25743,    6095,   -1359,143117,   -1593,59750
449,JAPANESE YEN - CHICAGO MERCANTILE EXCHANGE,2016-06-21,79398,27102,    1695,    5089,144710,    5658,52296
450,JAPANESE YEN - CHICAGO MERCANTILE EXCHANGE,2016-06-14,77703,22013,    9466,   -3371,139052,  -41842,55690
451,JAPANESE YEN - CHICAGO MERCANTILE EXCHANGE,2016-06-07,68237,25384,   21273,   -6743,180894,   24395,42853
452,JAPANESE YEN - CHICAGO MERCANTILE EXCHANGE,2016-05-31,46964,32127,   -7828,    -606,156499,   -3334,14837
453,JAPANESE YEN - CHICAGO MERCANTILE EXCHANGE,2016-05-24,54792,32733,  -31373,    5487,159833,     924,22059
454,JAPANESE YEN - CHICAGO MERCANTILE EXCHANGE,2016-05-17,86165,27246,   -2732,   -2604,158909,   -6640,58919
455,JAPANESE YEN - CHICAGO MERCANTILE EXCHANGE,2016-05-10,88897,29850,    3270,    5744,165549,    4020,59047
456,JAPANESE YEN - CHICAGO MERCANTILE EXCHANGE,2016-05-03,85627,24106,  -11843,   -6866,161529,   -7238,61521
457,JAPANESE YEN - CHICAGO MERCANTILE EXCHANGE,2016-04-26,97470,30972,   -8240,   -2868,168767,  -11121,66498
458,JAPANESE YEN - CHICAGO MERCANTILE EXCHANGE,2016-04-19,105710,33840,    5590,     -90,179888,    6373,71870
459,JAPANESE YEN - CHICAGO MERCANTILE EXCHANGE,2016-04-12,100120,33930,    1990,   -4127,173515,    6684,66190
460,JAPANESE YEN - CHICAGO MERCANTILE EXCHANGE,2016-04-05,98130,38057,   13260,    7574,166831,   18539,60073
461,JAPANESE YEN - CHICAGO MERCANTILE EXCHANGE,2016-03-29,84870,30483,    2058,    1017,148292,    1871,54387
462,JAPANESE YEN - CHICAGO MERCANTILE EXCHANGE,2016-03-22,82812,29466,    3386,   -4471,146421,    6337,53346
463,JAPANESE YEN - CHICAGO MERCANTILE EXCHANGE,2016-03-15,79426,33937,  -14441,    4403,140084, -149795,45489
464,JAPANESE YEN - CHICAGO MERCANTILE EXCHANGE,2016-03-08,93867,29534,    -203,   -4911,289879,   28200,64333
465,JAPANESE YEN - CHICAGO MERCANTILE EXCHANGE,2016-03-01,94070,34445,    1694,   -5197,261679,    4615,59625
466,JAPANESE YEN - CHICAGO MERCANTILE EXCHANGE,2016-02-23,92376,39642,    7858,    3025,257064,    8079,52734
467,JAPANESE YEN - CHICAGO MERCANTILE EXCHANGE,2016-02-16,84518,36617,    8707,    4038,248985,   11904,47901
468,JAPANESE YEN - CHICAGO MERCANTILE EXCHANGE,2016-02-09,75811,32579,   -6297,  -12284,237081,    -208,43232
469,JAPANESE YEN - CHICAGO MERCANTILE EXCHANGE,2016-02-02,82108,44863,  -10520,    2261,237289,  -13422,37245
470,JAPANESE YEN - CHICAGO MERCANTILE EXCHANGE,2016-01-26,92628,42602,    8143,   -4230,250711,    3097,50026
471,JAPANESE YEN - CHICAGO MERCANTILE EXCHANGE,2016-01-19,84485,46832,    6100,   -6287,247614,    6248,37653
472,JAPANESE YEN - CHICAGO MERCANTILE EXCHANGE,2016-01-12,78385,53119,   10914,  -10249,241366,   20659,25266
473,JAPANESE YEN - CHICAGO MERCANTILE EXCHANGE,2016-01-05,67471,63368,   22463,    1134,220707,   23882,4103
474,JAPANESE YEN - CHICAGO MERCANTILE EXCHANGE,2015-12-29,45008,62234,    7331,   -5810,196825,    -550,-17226
475,JAPANESE YEN - CHICAGO MERCANTILE EXCHANGE,2015-12-22,37677,68044,     376,    4163,197375,    3179,-30367
476,JAPANESE YEN - CHICAGO MERCANTILE EXCHANGE,2015-12-15,37301,63881,   10901,  -30569,194196,  -51859,-26580
477,JAPANESE YEN - CHICAGO MERCANTILE EXCHANGE,2015-12-08,26400,94450,   -4828,  -11679,246055,   -7450,-68050
478,JAPANESE YEN - CHICAGO MERCANTILE EXCHANGE,2015-12-01,31228,106129,     951,   -1484,253505,    5992,-74901
479,JAPANESE YEN - CHICAGO MERCANTILE EXCHANGE,2015-11-24,30277,107613,   -4198,   -5473,247513,   -2833,-77336
480,JAPANESE YEN - CHICAGO MERCANTILE EXCHANGE,2015-11-17,34475,113086,    -606,   11117,250346,   16144,-78611
481,JAPANESE YEN - CHICAGO MERCANTILE EXCHANGE,2015-11-10,35081,101969,   -6408,   16693,234202,   29931,-66888
482,JAPANESE YEN - CHICAGO MERCANTILE EXCHANGE,2015-11-03,41489,85276,    5052,   14928,204271,   14799,-43787
483,JAPANESE YEN - CHICAGO MERCANTILE EXCHANGE,2015-10-27,36437,70348,  -12310,   17962,189472,    5191,-33911
484,JAPANESE YEN - CHICAGO MERCANTILE EXCHANGE,2015-10-20,48747,52386,   10743,     550,184281,   14408,-3639
485,JAPANESE YEN - CHICAGO MERCANTILE EXCHANGE,2015-10-13,38004,51836,   -1046,   -4813,169873,    -907,-13832
486,JAPANESE YEN - CHICAGO MERCANTILE EXCHANGE,2015-10-06,39050,56649,    -703,   -5156,170780,   -3917,-17599
487,JAPANESE YEN - CHICAGO MERCANTILE EXCHANGE,2015-09-29,39753,61805,   -8529,  -10155,174697,   -2742,-22052
488,JAPANESE YEN - CHICAGO MERCANTILE EXCHANGE,2015-09-22,48282,71960,   11833,    8697,177439,   11358,-23678
489,JAPANESE YEN - CHICAGO MERCANTILE EXCHANGE,2015-09-15,36449,63263,  -26672,   -6520,166081, -113631,-26814
490,JAPANESE YEN - CHICAGO MERCANTILE EXCHANGE,2015-09-08,63121,69783,   -4902,  -13795,279712,    6507,-6662
491,JAPANESE YEN - CHICAGO MERCANTILE EXCHANGE,2015-09-01,68023,83578,    8101,  -15403,273205,   12747,-15555
492,JAPANESE YEN - CHICAGO MERCANTILE EXCHANGE,2015-08-25,59922,98981,   13987,  -37084,260458,    9040,-39059
493,JAPANESE YEN - CHICAGO MERCANTILE EXCHANGE,2015-08-18,45935,136065,     167,  -14929,251418,  -13190,-90130
494,JAPANESE YEN - CHICAGO MERCANTILE EXCHANGE,2015-08-11,45768,150994,   -4138,   21372,264608,   11953,-105226
495,JAPANESE YEN - CHICAGO MERCANTILE EXCHANGE,2015-08-04,49906,129622,    3636,   19814,252655,    6386,-79716
496,JAPANESE YEN - CHICAGO MERCANTILE EXCHANGE,2015-07-28,46270,109808,   -4629,   -3405,246269,   -4867,-63538
497,JAPANESE YEN - CHICAGO MERCANTILE EXCHANGE,2015-07-21,50899,113213,    1732,   16675,251136,    3432,-62314
498,JAPANESE YEN - CHICAGO MERCANTILE EXCHANGE,2015-07-14,49167,96538,    3097,  -13161,247704,   -3124,-47371
499,JAPANESE YEN - CHICAGO MERCANTILE EXCHANGE,2015-07-07,46070,109699,     591,  -14602,250828,   -3186,-63629
500,JAPANESE YEN - CHICAGO MERCANTILE EXCHANGE,2015-06-30,45479,124301,    6460,   -2435,254014,    6175,-78822
501,JAPANESE YEN - CHICAGO MERCANTILE EXCHANGE,2015-06-23,39019,126736,  -25741,  -18688,247839,  -14490,-87717
502,JAPANESE YEN - CHICAGO MERCANTILE EXCHANGE,2015-06-16,64760,145424,   22320,  -13302,262329,  -44120,-80664
503,JAPANESE YEN - CHICAGO MERCANTILE EXCHANGE,2015-06-09,42440,158726,   -4241,   26352,306449,   46345,-116286
504,JAPANESE YEN - CHICAGO MERCANTILE EXCHANGE,2015-06-02,46681,132374,   -3529,   19940,260104,    8360,-85693
505,JAPANESE YEN - CHICAGO MERCANTILE EXCHANGE,2015-05-26,50210,112434,  -13188,   27031,251744,   20086,-62224
506,JAPANESE YEN - CHICAGO MERCANTILE EXCHANGE,2015-05-19,63398,85403,   25550,   23962,231658,   38362,-22005
507,JAPANESE YEN - CHICAGO MERCANTILE EXCHANGE,2015-05-12,37848,61441,   -4004,  -11594,193296,   -5590,-23593
508,JAPANESE YEN - CHICAGO MERCANTILE EXCHANGE,2015-05-05,41852,73035,   -6869,   18821,198886,   10807,-31183
509,JAPANESE YEN - CHICAGO MERCANTILE EXCHANGE,2015-04-28,48721,54214,   -2799,  -11754,188079,   -1253,-5493
510,JAPANESE YEN - CHICAGO MERCANTILE EXCHANGE,2015-04-21,51520,65968,   -3263,  -11885,189332,   -5898,-14448
511,JAPANESE YEN - CHICAGO MERCANTILE EXCHANGE,2015-04-14,54783,77853,    1463,      84,195230,    5786,-23070
512,JAPANESE YEN - CHICAGO MERCANTILE EXCHANGE,2015-04-07,53320,77769,    8911,    9436,189444,   11966,-24449
513,JAPANESE YEN - CHICAGO MERCANTILE EXCHANGE,2015-03-31,44409,68333,    5253,  -16728,177478,   -3548,-23924
514,JAPANESE YEN - CHICAGO MERCANTILE EXCHANGE,2015-03-24,39156,85061,   -5340,   -7489,181026,  -14887,-45905
515,JAPANESE YEN - CHICAGO MERCANTILE EXCHANGE,2015-03-17,44496,92550,   11598,     265,195913,  -39176,-48054
516,JAPANESE YEN - CHICAGO MERCANTILE EXCHANGE,2015-03-10,32898,92285,   -1046,    5820,235089,   24478,-59387
517,JAPANESE YEN - CHICAGO MERCANTILE EXCHANGE,2015-03-03,33944,86465,    2333,    7342,210611,    8173,-52521
518,JAPANESE YEN - CHICAGO MERCANTILE EXCHANGE,2015-02-24,31611,79123,     342,   -1237,202438,   -1117,-47512
519,JAPANESE YEN - CHICAGO MERCANTILE EXCHANGE,2015-02-17,31269,80360,    5385,    -648,203555,    -638,-49091
520,JAPANESE YEN - CHICAGO MERCANTILE EXCHANGE,2015-02-10,25884,81008,     298,   -4149,204193,     230,-55124
521,JAPANESE YEN - CHICAGO MERCANTILE EXCHANGE,2015-02-03,25586,85157,    -940,   -6027,203963,    1392,-59571
522,JAPANESE YEN - CHICAGO MERCANTILE EXCHANGE,2015-01-27,26526,91184,       1,  -13227,202571,  -12842,-64658
523,JAPANESE YEN - CHICAGO MERCANTILE EXCHANGE,2015-01-20,26525,104411,     653,  -16086,215413,  -15810,-77886
524,JAPANESE YEN - CHICAGO MERCANTILE EXCHANGE,2015-01-13,25872,120497,   -7288,   -2746,231223,    2269,-94625
525,JAPANESE YEN - CHICAGO MERCANTILE EXCHANGE,2015-01-06,33160,123243,    4324,   -1912,228954,    2325,-90083
526,JAPANESE YEN - CHICAGO MERCANTILE EXCHANGE,2014-12-30,28836,125155,    -185,    2392,226629,     522,-96319
527,JAPANESE YEN - CHICAGO MERCANTILE EXCHANGE,2014-12-23,29021,122763,  -16631,   -9816,226107,   -1578,-93742
528,JAPANESE YEN - CHICAGO MERCANTILE EXCHANGE,2014-12-16,45652,132579,    7585,   -9624,227685,  -52174,-86927
529,JAPANESE YEN - CHICAGO MERCANTILE EXCHANGE,2014-12-09,38067,142203,   -3463,  -10487,279859,   22031,-104136
530,JAPANESE YEN - CHICAGO MERCANTILE EXCHANGE,2014-12-02,41530,152690,   -4774,    2006,257828,    3852,-111160
531,JAPANESE YEN - CHICAGO MERCANTILE EXCHANGE,2014-11-25,46304,150684,    -308,   11618,253976,   15078,-104380
532,JAPANESE YEN - CHICAGO MERCANTILE EXCHANGE,2014-11-18,46612,139066,    -659,    9232,238898,   11322,-92454
533,JAPANESE YEN - CHICAGO MERCANTILE EXCHANGE,2014-11-11,47271,129834,    9354,   20266,227576,   19602,-82563
534,JAPANESE YEN - CHICAGO MERCANTILE EXCHANGE,2014-11-04,37917,109568,   14034,   18286,207974,   23854,-71651
535,JAPANESE YEN - CHICAGO MERCANTILE EXCHANGE,2014-10-28,23883,91282,   -2751,   -7090,184120,   -1292,-67399
536,JAPANESE YEN - CHICAGO MERCANTILE EXCHANGE,2014-10-21,26634,98372,    3795,  -25614,185412,  -27008,-71738
537,JAPANESE YEN - CHICAGO MERCANTILE EXCHANGE,2014-10-14,22839,123986,   -1998,  -13402,212420,  -10835,-101147
538,JAPANESE YEN - CHICAGO MERCANTILE EXCHANGE,2014-10-07,24837,137388,   -5073,  -13400,223255,  -16222,-112551
539,JAPANESE YEN - CHICAGO MERCANTILE EXCHANGE,2014-09-30,29910,150788,    1519,   16975,239477,   17263,-120878
540,JAPANESE YEN - CHICAGO MERCANTILE EXCHANGE,2014-09-23,28391,133813,   -9226,   13014,222214,   13979,-105422
541,JAPANESE YEN - CHICAGO MERCANTILE EXCHANGE,2014-09-16,37617,120799,   20337,    2846,208235,  -47389,-83182
542,JAPANESE YEN - CHICAGO MERCANTILE EXCHANGE,2014-09-09,17280,117953,    1795,  -14840,255624,   24687,-100673
543,JAPANESE YEN - CHICAGO MERCANTILE EXCHANGE,2014-09-02,15485,132793,   -4027,   10390,230937,   12928,-117308
544,JAPANESE YEN - CHICAGO MERCANTILE EXCHANGE,2014-08-26,19512,122403,    1536,   17156,218009,   14829,-102891
545,JAPANESE YEN - CHICAGO MERCANTILE EXCHANGE,2014-08-19,17976,105247,    5458,   11632,203180,   11040,-87271
546,JAPANESE YEN - CHICAGO MERCANTILE EXCHANGE,2014-08-12,12518,93615,    2622,  -11680,192140,    -766,-81097
547,JAPANESE YEN - CHICAGO MERCANTILE EXCHANGE,2014-08-05,9896,105295,    2068,   24398,192906,   20696,-95399
548,JAPANESE YEN - CHICAGO MERCANTILE EXCHANGE,2014-07-29,7828,80897,   -4151,   15002,172210,   10181,-73069
549,JAPANESE YEN - CHICAGO MERCANTILE EXCHANGE,2014-07-22,11979,65895,    3594,   -5438,162029,    6902,-53916
550,JAPANESE YEN - CHICAGO MERCANTILE EXCHANGE,2014-07-15,8385,71333,   -2789,   -6216,155127,   -2583,-62948
551,JAPANESE YEN - CHICAGO MERCANTILE EXCHANGE,2014-07-08,11174,77549,   -7565,     124,157710,    1230,-66375
552,JAPANESE YEN - CHICAGO MERCANTILE EXCHANGE,2014-07-01,18739,77425,    8414,   -4123,156480,    8223,-58686
553,JAPANESE YEN - CHICAGO MERCANTILE EXCHANGE,2014-06-24,10325,81548,   -7507,   -4322,148257,   -4750,-71223
554,JAPANESE YEN - CHICAGO MERCANTILE EXCHANGE,2014-06-17,17832,85870,    5939,   -8185,153007,  -48087,-68038
555,JAPANESE YEN - CHICAGO MERCANTILE EXCHANGE,2014-06-10,11893,94055,    -685,    7259,201094,   29290,-82162
556,JAPANESE YEN - CHICAGO MERCANTILE EXCHANGE,2014-06-03,12578,86796,   -4421,   10761,171804,    8984,-74218
557,JAPANESE YEN - CHICAGO MERCANTILE EXCHANGE,2014-05-27,16999,76035,   -1682,    3567,162820,   -1999,-59036
558,JAPANESE YEN - CHICAGO MERCANTILE EXCHANGE,2014-05-20,18681,72468,    1210,   -9710,164819,     112,-53787
559,JAPANESE YEN - CHICAGO MERCANTILE EXCHANGE,2014-05-13,17471,82178,   -2910,    1069,164707,   -2386,-64707
560,JAPANESE YEN - CHICAGO MERCANTILE EXCHANGE,2014-05-06,20381,81109,    6535,   -3089,167093,   -1727,-60728
561,JAPANESE YEN - CHICAGO MERCANTILE EXCHANGE,2014-04-29,13846,84198,   -2718,     391,168820,    3146,-70352
562,JAPANESE YEN - CHICAGO MERCANTILE EXCHANGE,2014-04-22,16564,83807,    2213,     740,165674,     831,-67243
563,JAPANESE YEN - CHICAGO MERCANTILE EXCHANGE,2014-04-15,14351,83067,    1011,  -17735,164843,  -16971,-68716
564,JAPANESE YEN - CHICAGO MERCANTILE EXCHANGE,2014-04-08,13340,100802,   -8822,   -9998,181814,   -6650,-87462
565,JAPANESE YEN - CHICAGO MERCANTILE EXCHANGE,2014-04-01,22162,110800,    4562,   24313,188464,   30184,-88638
566,JAPANESE YEN - CHICAGO MERCANTILE EXCHANGE,2014-03-25,17600,86487,   -6544,    1244,158280,    1358,-68887
567,JAPANESE YEN - CHICAGO MERCANTILE EXCHANGE,2014-03-18,24144,85243,    8418,  -29839,156922,  -85248,-61099
568,JAPANESE YEN - CHICAGO MERCANTILE EXCHANGE,2014-03-11,15726,115082,   -4681,   14966,242170,   36284,-99356
569,JAPANESE YEN - CHICAGO MERCANTILE EXCHANGE,2014-03-04,20407,100116,    5680,     299,205886,    2143,-79709
570,JAPANESE YEN - CHICAGO MERCANTILE EXCHANGE,2014-02-25,14727,99817,   -2009,    3297,203743,    3686,-85090
571,JAPANESE YEN - CHICAGO MERCANTILE EXCHANGE,2014-02-18,16736,96520,    3050,    4048,200057,    3622,-79784
572,JAPANESE YEN - CHICAGO MERCANTILE EXCHANGE,2014-02-11,13686,92472,   -2210,    -253,196435,   -2926,-78786
573,JAPANESE YEN - CHICAGO MERCANTILE EXCHANGE,2014-02-04,15896,92725,     -81,   -9444,199361,   -3653,-76829
574,JAPANESE YEN - CHICAGO MERCANTILE EXCHANGE,2014-01-28,15977,102169,    2849,  -25920,203014,  -14534,-86192
575,JAPANESE YEN - CHICAGO MERCANTILE EXCHANGE,2014-01-21,13128,128089,    2374,    -731,217548,    -776,-114961
576,JAPANESE YEN - CHICAGO MERCANTILE EXCHANGE,2014-01-14,10754,128820,    -586,  -11388,218324,  -11832,-118066
577,JAPANESE YEN - CHICAGO MERCANTILE EXCHANGE,2014-01-07,11340,140208,   -2934,   -9294,230156,   -2069,-128868
578,JAPANESE YEN - CHICAGO MERCANTILE EXCHANGE,2013-12-31,14274,149502,      13,   -8581,232225,   -6935,-135228
579,JAPANESE YEN - CHICAGO MERCANTILE EXCHANGE,2013-12-24,14261,158083,   -7964,    5635,239160,    6417,-143822
580,JAPANESE YEN - CHICAGO MERCANTILE EXCHANGE,2013-12-17,22225,152448,    4140,    4652,232743,  -29486,-130223
581,JAPANESE YEN - CHICAGO MERCANTILE EXCHANGE,2013-12-10,18085,147796,   -3205,   -6877,262229,   17062,-129711
582,JAPANESE YEN - CHICAGO MERCANTILE EXCHANGE,2013-12-03,21290,154673,   -2709,    7472,245167,    8454,-133383
583,JAPANESE YEN - CHICAGO MERCANTILE EXCHANGE,2013-11-26,23999,147201,    4575,   15561,236713,   22502,-123202
584,JAPANESE YEN - CHICAGO MERCANTILE EXCHANGE,2013-11-19,19424,131640,   -1553,   15556,214211,   18521,-112216
585,JAPANESE YEN - CHICAGO MERCANTILE EXCHANGE,2013-11-12,20977,116084,    2243,   23558,195690,   26686,-95107
586,JAPANESE YEN - CHICAGO MERCANTILE EXCHANGE,2013-11-05,18734,92526,    1251,   12648,169004,   17017,-73792
587,JAPANESE YEN - CHICAGO MERCANTILE EXCHANGE,2013-10-29,17483,79878,    3555,   -5852,151987,    -951,-62395
588,JAPANESE YEN - CHICAGO MERCANTILE EXCHANGE,2013-10-22,13928,85730,  -11464,    1072,152938,   -6933,-71802
589,JAPANESE YEN - CHICAGO MERCANTILE EXCHANGE,2013-10-15,25392,84658,   -2773,    -604,159871,   -6086,-59266
590,JAPANESE YEN - CHICAGO MERCANTILE EXCHANGE,2013-10-08,28165,85262,    9531,  -15696,165957,   -4568,-57097
591,JAPANESE YEN - CHICAGO MERCANTILE EXCHANGE,2013-10-01,18634,100958,     461,  -10033,170525,   -4367,-82324
592,JAPANESE YEN - CHICAGO MERCANTILE EXCHANGE,2013-09-24,18173,110991,   -7915,   -3891,174892,   -2153,-92818
593,JAPANESE YEN - CHICAGO MERCANTILE EXCHANGE,2013-09-17,26088,114882,    7234,     962,177045,  -20054,-88794
594,JAPANESE YEN - CHICAGO MERCANTILE EXCHANGE,2013-09-10,18854,113920,   -8811,    6494,197099,   18739,-95066
595,JAPANESE YEN - CHICAGO MERCANTILE EXCHANGE,2013-09-03,27665,107426,    4269,    5677,178360,    2772,-79761
596,JAPANESE YEN - CHICAGO MERCANTILE EXCHANGE,2013-08-27,23396,101749,    3676,   10308,175588,   13420,-78353
597,JAPANESE YEN - CHICAGO MERCANTILE EXCHANGE,2013-08-20,19720,91441,    2345,    -396,162168,    2672,-71721
598,JAPANESE YEN - CHICAGO MERCANTILE EXCHANGE,2013-08-13,17375,91837,   -2046,   -7797,159496,  -12563,-74462
599,JAPANESE YEN - CHICAGO MERCANTILE EXCHANGE,2013-08-06,19421,99634,    1205,    -717,172059,   -2813,-80213
600,JAPANESE YEN - CHICAGO MERCANTILE EXCHANGE,2013-07-30,18216,100351,   -4297,   -9658,174872,  -12378,-82135
601,JAPANESE YEN - CHICAGO MERCANTILE EXCHANGE,2013-07-23,22513,110009,    2293,    4027,187250,    4821,-87496
602,JAPANESE YEN - CHICAGO MERCANTILE EXCHANGE,2013-07-16,20220,105982,   -4897,     560,182429,   -2820,-85762
603,JAPANESE YEN - CHICAGO MERCANTILE EXCHANGE,2013-07-09,25117,105422,   -2219,    7350,185249,    6323,-80305
604,JAPANESE YEN - CHICAGO MERCANTILE EXCHANGE,2013-07-02,27336,98072,    2960,   12234,178926,   17766,-70736
605,JAPANESE YEN - CHICAGO MERCANTILE EXCHANGE,2013-06-25,24376,85838,    1366,     938,161160,   -2761,-61462
606,JAPANESE YEN - CHICAGO MERCANTILE EXCHANGE,2013-06-18,23010,84900,    1288,   -9728,163921,  -79723,-61890
607,JAPANESE YEN - CHICAGO MERCANTILE EXCHANGE,2013-06-11,21722,94628,    2546,   -7292,243644,   24509,-72906
608,JAPANESE YEN - CHICAGO MERCANTILE EXCHANGE,2013-06-04,19176,101920,     770,  -16255,219135,  -11877,-82744
609,JAPANESE YEN - CHICAGO MERCANTILE EXCHANGE,2013-05-28,18406,118175,   -1048,    3535,231012,    3186,-99769
610,JAPANESE YEN - CHICAGO MERCANTILE EXCHANGE,2013-05-21,19454,114640,   -9428,   -2649,227826,   -1920,-95186
611,JAPANESE YEN - CHICAGO MERCANTILE EXCHANGE,2013-05-14,28882,117289,     996,   10843,229746,   20376,-88407
612,JAPANESE YEN - CHICAGO MERCANTILE EXCHANGE,2013-05-07,27886,106446,    3014,   10447,209370,   11264,-78560
613,JAPANESE YEN - CHICAGO MERCANTILE EXCHANGE,2013-04-30,24872,95999,   -1070,   -9673,198106,   -6044,-71127
614,JAPANESE YEN - CHICAGO MERCANTILE EXCHANGE,2013-04-23,25942,105672,    -506,  -14187,204150,  -10427,-79730
615,JAPANESE YEN - CHICAGO MERCANTILE EXCHANGE,2013-04-16,26448,119859,  -13251,    2463,214577,   -6049,-93411
616,JAPANESE YEN - CHICAGO MERCANTILE EXCHANGE,2013-04-09,39699,117396,   -7267,   -7741,220626,    6629,-77697
617,JAPANESE YEN - CHICAGO MERCANTILE EXCHANGE,2013-04-02,46966,125137,      35,  -10943,213997,   -6899,-78171
618,JAPANESE YEN - CHICAGO MERCANTILE EXCHANGE,2013-03-26,46931,136080,   -8477,     679,220896,    4222,-89149
619,JAPANESE YEN - CHICAGO MERCANTILE EXCHANGE,2013-03-19,55408,135401,    4168,   -9602,216674,  -71800,-79993
620,JAPANESE YEN - CHICAGO MERCANTILE EXCHANGE,2013-03-12,51240,145003,     282,   20694,288474,   46536,-93763
621,JAPANESE YEN - CHICAGO MERCANTILE EXCHANGE,2013-03-05,50958,124309,   -1040,    6967,241938,   25615,-73351
622,JAPANESE YEN - CHICAGO MERCANTILE EXCHANGE,2013-02-26,51998,117342,   -2664,   -3211,216323,   -1918,-65344
623,JAPANESE YEN - CHICAGO MERCANTILE EXCHANGE,2013-02-19,54662,120553,   -1120,    3465,218241,    3205,-65891
624,JAPANESE YEN - CHICAGO MERCANTILE EXCHANGE,2013-02-12,55782,117088,    5115,   -1992,215036,   -2673,-61306
625,JAPANESE YEN - CHICAGO MERCANTILE EXCHANGE,2013-02-05,50667,119080,    2191,    -642,217709,   -1926,-68413
626,JAPANESE YEN - CHICAGO MERCANTILE EXCHANGE,2013-01-29,48476,119722,    6493,   13671,219635,   17410,-71246
627,JAPANESE YEN - CHICAGO MERCANTILE EXCHANGE,2013-01-22,41983,106051,    2536,     877,202225,    5716,-64068
628,JAPANESE YEN - CHICAGO MERCANTILE EXCHANGE,2013-01-15,39447,105174,    7318,   -1051,196509,    3214,-65727
629,JAPANESE YEN - CHICAGO MERCANTILE EXCHANGE,2013-01-08,32129,106225,    1697,   -4724,193295,   -1337,-74096
630,JAPANESE YEN - CHICAGO MERCANTILE EXCHANGE,2012-12-31,30432,110949,    3675,   -1416,194632,   -1073,-80517
631,JAPANESE YEN - CHICAGO MERCANTILE EXCHANGE,2012-12-24,26757,112365,   -1178,   -4733,195705,    -957,-85608
632,JAPANESE YEN - CHICAGO MERCANTILE EXCHANGE,2012-12-18,27935,117098,   11566,    6328,196662,  -70920,-89163
633,JAPANESE YEN - CHICAGO MERCANTILE EXCHANGE,2012-12-11,16369,110770,   -4560,    -485,267582,   46600,-94401
634,JAPANESE YEN - CHICAGO MERCANTILE EXCHANGE,2012-12-04,20929,111255,   -6098,    4762,220982,   12852,-90326
635,JAPANESE YEN - CHICAGO MERCANTILE EXCHANGE,2012-11-27,27027,106493,   -1245,   26832,208130,   27151,-79466
636,JAPANESE YEN - CHICAGO MERCANTILE EXCHANGE,2012-11-20,28272,79661,    6292,   27234,180979,   25048,-51389
637,JAPANESE YEN - CHICAGO MERCANTILE EXCHANGE,2012-11-13,21980,52427,   -2986,  -12643,155931,   -5621,-30447
638,JAPANESE YEN - CHICAGO MERCANTILE EXCHANGE,2012-11-06,24966,65070,    5080,    8164,161552,   14417,-40104
639,JAPANESE YEN - CHICAGO MERCANTILE EXCHANGE,2012-10-30,19886,56906,   -5664,   13160,147135,   10000,-37020
640,JAPANESE YEN - CHICAGO MERCANTILE EXCHANGE,2012-10-23,25550,43746,  -17217,   11065,137135,    5792,-18196
641,JAPANESE YEN - CHICAGO MERCANTILE EXCHANGE,2012-10-16,42767,32681,    1989,    4817,131343,    3901,10086
642,JAPANESE YEN - CHICAGO MERCANTILE EXCHANGE,2012-10-09,40778,27864,  -11918,    4503,127442,  -14251,12914
643,JAPANESE YEN - CHICAGO MERCANTILE EXCHANGE,2012-10-02,52696,23361,    5378,   -2846,141693,    4001,29335
644,JAPANESE YEN - CHICAGO MERCANTILE EXCHANGE,2012-09-25,47318,26207,    5818,     183,137692,    8830,21111
645,JAPANESE YEN - CHICAGO MERCANTILE EXCHANGE,2012-09-18,41500,26024,  -19362,   -2065,128862,  -47756,15476
646,JAPANESE YEN - CHICAGO MERCANTILE EXCHANGE,2012-09-11,60862,28089,    5729,   -3037,176618,   24166,32773
647,JAPANESE YEN - CHICAGO MERCANTILE EXCHANGE,2012-09-04,55133,31126,    1562,    -889,152452,    3008,24007
648,JAPANESE YEN - CHICAGO MERCANTILE EXCHANGE,2012-08-28,53571,32015,    9987,    -398,149444,    7986,21556
649,JAPANESE YEN - CHICAGO MERCANTILE EXCHANGE,2012-08-21,43584,32413,  -12399,    7134,141458,   -9578,11171
650,JAPANESE YEN - CHICAGO MERCANTILE EXCHANGE,2012-08-14,55983,25279,     100,   -3065,151036,    2038,30704
651,JAPANESE YEN - CHICAGO MERCANTILE EXCHANGE,2012-08-07,55883,28344,     510,    5225,148998,    4903,27539
652,JAPANESE YEN - CHICAGO MERCANTILE EXCHANGE,2012-07-31,55373,23119,    3349,   -3844,144095,    5062,32254
653,JAPANESE YEN - CHICAGO MERCANTILE EXCHANGE,2012-07-24,52024,26963,   15290,    1350,139033,   17227,25061
654,JAPANESE YEN - CHICAGO MERCANTILE EXCHANGE,2012-07-17,36734,25613,    3814,    1645,121806,    6284,11121
655,JAPANESE YEN - CHICAGO MERCANTILE EXCHANGE,2012-07-10,32920,23968,   -4030,   -8807,115522,   -1881,8952
656,JAPANESE YEN - CHICAGO MERCANTILE EXCHANGE,2012-07-03,36950,32775,   -6960,   -6593,117403,   -5844,4175
657,JAPANESE YEN - CHICAGO MERCANTILE EXCHANGE,2012-06-26,43910,39368,    -830,    9765,123247,    -621,4542
658,JAPANESE YEN - CHICAGO MERCANTILE EXCHANGE,2012-06-19,44740,29603,    6558,    3728,123868,  -50410,15137
659,JAPANESE YEN - CHICAGO MERCANTILE EXCHANGE,2012-06-12,38182,25875,     806,     572,174278,    4615,12307
660,JAPANESE YEN - CHICAGO MERCANTILE EXCHANGE,2012-06-05,37376,25303,   15756,   -7647,169663,   28979,12073
661,JAPANESE YEN - CHICAGO MERCANTILE EXCHANGE,2012-05-29,21620,32950,    1137,   -5548,140684,   -1484,-11330
662,JAPANESE YEN - CHICAGO MERCANTILE EXCHANGE,2012-05-22,20483,38498,    3028,  -13272,142168,    2893,-18015
663,JAPANESE YEN - CHICAGO MERCANTILE EXCHANGE,2012-05-15,17455,51770,    1086,   -5692,139275,   -2567,-34315
664,JAPANESE YEN - CHICAGO MERCANTILE EXCHANGE,2012-05-08,16369,57462,    2259,   -6821,141842,    1493,-41093
665,JAPANESE YEN - CHICAGO MERCANTILE EXCHANGE,2012-05-01,14110,64283,    1441,   -4289,140349,    2713,-50173
666,JAPANESE YEN - CHICAGO MERCANTILE EXCHANGE,2012-04-24,12669,68572,   -4248,   -6148,137636,   -6532,-55903
667,JAPANESE YEN - CHICAGO MERCANTILE EXCHANGE,2012-04-17,16917,74720,     820,   -7461,144168,   -6707,-57803
668,JAPANESE YEN - CHICAGO MERCANTILE EXCHANGE,2012-04-10,16097,82181,    1534,    2510,150875,     493,-66084
669,JAPANESE YEN - CHICAGO MERCANTILE EXCHANGE,2012-04-03,14563,79671,    3658,    1144,150382,    4885,-65108
670,JAPANESE YEN - CHICAGO MERCANTILE EXCHANGE,2012-03-27,10905,78527,  -24018,   17783,145497,    5728,-67622
671,JAPANESE YEN - CHICAGO MERCANTILE EXCHANGE,2012-03-20,34923,60744,   12674,   -3885,139769,  -56627,-25821
672,JAPANESE YEN - CHICAGO MERCANTILE EXCHANGE,2012-03-13,22249,64629,  -11032,   11990,196396,   48444,-42380
673,JAPANESE YEN - CHICAGO MERCANTILE EXCHANGE,2012-03-06,33281,52639,  -18277,    -122,147952,    -358,-19358
674,JAPANESE YEN - CHICAGO MERCANTILE EXCHANGE,2012-02-28,51558,52761,  -10504,    7956,148310,   -2241,-1203
675,JAPANESE YEN - CHICAGO MERCANTILE EXCHANGE,2012-02-21,62062,44805,   -2034,   10168,150551,   -3132,17257
676,JAPANESE YEN - CHICAGO MERCANTILE EXCHANGE,2012-02-14,64096,34637,  -20751,    4961,153683,  -24829,29459
677,JAPANESE YEN - CHICAGO MERCANTILE EXCHANGE,2012-02-07,84847,29676,    3793,    5291,178512,    5545,55171
678,JAPANESE YEN - CHICAGO MERCANTILE EXCHANGE,2012-01-31,81054,24385,   14860,    2558,172967,   20906,56669
679,JAPANESE YEN - CHICAGO MERCANTILE EXCHANGE,2012-01-24,66194,21827,  -12161,    2334,152061,  -16009,44367
680,JAPANESE YEN - CHICAGO MERCANTILE EXCHANGE,2012-01-17,78355,19493,    1684,    2479,168070,    4537,58862
681,JAPANESE YEN - CHICAGO MERCANTILE EXCHANGE,2012-01-10,76671,17014,    3685,     509,163533,    4814,59657
682,JAPANESE YEN - CHICAGO MERCANTILE EXCHANGE,2012-01-03,72986,16505,   20295,  -13601,158719,   26162,56481
683,JAPANESE YEN - CHICAGO MERCANTILE EXCHANGE,2011-12-27,52691,30106,     543,    2434,132557,     551,22585
684,JAPANESE YEN - CHICAGO MERCANTILE EXCHANGE,2011-12-20,52148,27672,    -101,   11023,132006,  -72812,24476
685,JAPANESE YEN - CHICAGO MERCANTILE EXCHANGE,2011-12-13,52249,16649,   -4568,   -1897,204818,   26193,35600
686,JAPANESE YEN - CHICAGO MERCANTILE EXCHANGE,2011-12-06,56817,18546,     655,    2931,178625,   12346,38271
687,JAPANESE YEN - CHICAGO MERCANTILE EXCHANGE,2011-11-29,56162,15615,    -856,    1777,166279,   16708,40547
688,JAPANESE YEN - CHICAGO MERCANTILE EXCHANGE,2011-11-22,57018,13838,    7102,   -2398,149571,    7338,43180
689,JAPANESE YEN - CHICAGO MERCANTILE EXCHANGE,2011-11-15,49916,16236,    5596,      -7,142233,    3252,33680
690,JAPANESE YEN - CHICAGO MERCANTILE EXCHANGE,2011-11-08,44320,16243,     649,   -1524,138981,     936,28077
691,JAPANESE YEN - CHICAGO MERCANTILE EXCHANGE,2011-11-01,43671,17767,  -32328,   -3953,138045,  -27571,25904
692,JAPANESE YEN - CHICAGO MERCANTILE EXCHANGE,2011-10-25,75999,21720,   26952,    -420,165616,   13361,54279
693,JAPANESE YEN - CHICAGO MERCANTILE EXCHANGE,2011-10-18,49047,22140,   -5143,    3069,152255,   -1594,26907
694,JAPANESE YEN - CHICAGO MERCANTILE EXCHANGE,2011-10-11,54190,19071,   -6677,    1666,153849,   19125,35119
695,JAPANESE YEN - CHICAGO MERCANTILE EXCHANGE,2011-10-04,60867,17405,    -299,   -1439,134724,    8992,43462
696,JAPANESE YEN - CHICAGO MERCANTILE EXCHANGE,2011-09-27,61166,18844,   -2722,     573,125732,   -2096,42322
697,JAPANESE YEN - CHICAGO MERCANTILE EXCHANGE,2011-09-20,63888,18271,   10110,    -552,127828,  -23707,45617
698,JAPANESE YEN - CHICAGO MERCANTILE EXCHANGE,2011-09-13,53778,18823,    5653,    3485,151535,   28123,34955
699,JAPANESE YEN - CHICAGO MERCANTILE EXCHANGE,2011-09-06,48125,15338,   -6011,    2387,123412,   -2716,32787
700,JAPANESE YEN - CHICAGO MERCANTILE EXCHANGE,2011-08-30,54136,12951,   -6695,    -741,126128,   -5089,41185
701,JAPANESE YEN - CHICAGO MERCANTILE EXCHANGE,2011-08-23,60831,13692,    1771,    1980,131217,    4955,47139
702,JAPANESE YEN - CHICAGO MERCANTILE EXCHANGE,2011-08-16,59060,11712,    5674,     475,126262,    6358,47348
703,JAPANESE YEN - CHICAGO MERCANTILE EXCHANGE,2011-08-09,53386,11237,  -25469,   -8785,119904,  -28984,42149
704,JAPANESE YEN - CHICAGO MERCANTILE EXCHANGE,2011-08-02,78855,20022,    6741,    -790,148888,    9956,58833
705,JAPANESE YEN - CHICAGO MERCANTILE EXCHANGE,2011-07-26,72114,20812,    8579,    -568,138932,    9279,51302
706,JAPANESE YEN - CHICAGO MERCANTILE EXCHANGE,2011-07-19,63535,21380,   11258,   -2609,129653,   13807,42155
707,JAPANESE YEN - CHICAGO MERCANTILE EXCHANGE,2011-07-12,52277,23989,   17682,    3721,115846,   20945,28288
708,JAPANESE YEN - CHICAGO MERCANTILE EXCHANGE,2011-07-05,34595,20268,     276,    -428,94901,     615,14327
709,JAPANESE YEN - CHICAGO MERCANTILE EXCHANGE,2011-06-28,34319,20696,  -12755,    6216,94286,   -4785,13623
710,JAPANESE YEN - CHICAGO MERCANTILE EXCHANGE,2011-06-21,47074,14480,    8456,     630,99071,    4588,32594
711,JAPANESE YEN - CHICAGO MERCANTILE EXCHANGE,2011-06-14,38618,13850,    2735,   -4402,94483,  -11716,24768
712,JAPANESE YEN - CHICAGO MERCANTILE EXCHANGE,2011-06-07,35883,18252,   11697,   -7582,106199,   10270,17631
713,JAPANESE YEN - CHICAGO MERCANTILE EXCHANGE,2011-05-31,24186,25834,   -8002,    1652,95929,   -3335,-1648
714,JAPANESE YEN - CHICAGO MERCANTILE EXCHANGE,2011-05-24,32188,24182,   -5828,    1539,99264,   -4189,8006
715,JAPANESE YEN - CHICAGO MERCANTILE EXCHANGE,2011-05-17,38016,22643,    1916,    -403,103453,    1164,15373
716,JAPANESE YEN - CHICAGO MERCANTILE EXCHANGE,2011-05-10,36100,23046,   16321,  -15552,102289,   -2301,13054
717,JAPANESE YEN - CHICAGO MERCANTILE EXCHANGE,2011-05-03,19779,38598,    5716,  -12462,104590,   -9544,-18819
718,JAPANESE YEN - CHICAGO MERCANTILE EXCHANGE,2011-04-26,14063,51060,    1128,  -14858,114134,  -13704,-36997
719,JAPANESE YEN - CHICAGO MERCANTILE EXCHANGE,2011-04-19,12935,65918,   -1248,   -1142,127838,   -2246,-52983
720,JAPANESE YEN - CHICAGO MERCANTILE EXCHANGE,2011-04-12,14183,67060,   -2333,    7313,130084,    9452,-52877
721,JAPANESE YEN - CHICAGO MERCANTILE EXCHANGE,2011-04-05,16516,59747,  -21221,   29062,120632,   20255,-43231
722,JAPANESE YEN - CHICAGO MERCANTILE EXCHANGE,2011-03-29,37737,30685,  -14747,   12726,100377,  -11674,7052
723,JAPANESE YEN - CHICAGO MERCANTILE EXCHANGE,2011-03-22,52484,17959,    -119,   -4414,112051,   -2650,34525
724,JAPANESE YEN - CHICAGO MERCANTILE EXCHANGE,2011-03-15,52603,22373,    9398,   -4176,114701,  -16546,30230
725,JAPANESE YEN - CHICAGO MERCANTILE EXCHANGE,2011-03-08,43205,26549,  -19191,    5427,131247,   -5314,16656
726,JAPANESE YEN - CHICAGO MERCANTILE EXCHANGE,2011-03-01,62396,21122,   38939,  -30081,136561,   12545,41274
727,JAPANESE YEN - CHICAGO MERCANTILE EXCHANGE,2011-02-22,23457,51203,    -932,    8266,124016,    7213,-27746
728,JAPANESE YEN - CHICAGO MERCANTILE EXCHANGE,2011-02-15,24389,42937,  -32218,   23061,116803,    -902,-18548
729,JAPANESE YEN - CHICAGO MERCANTILE EXCHANGE,2011-02-08,56607,19876,    3959,   -1291,117705,    1321,36731
730,JAPANESE YEN - CHICAGO MERCANTILE EXCHANGE,2011-02-01,52648,21167,   -1847,   -1110,116384,    -277,31481
731,JAPANESE YEN - CHICAGO MERCANTILE EXCHANGE,2011-01-25,54495,22277,    8237,   -3452,116661,    6256,32218
732,JAPANESE YEN - CHICAGO MERCANTILE EXCHANGE,2011-01-18,46258,25729,    2374,    6581,110405,    3273,20529
733,JAPANESE YEN - CHICAGO MERCANTILE EXCHANGE,2011-01-11,43884,19148,  -22040,   -7711,107132,  -21351,24736
734,JAPANESE YEN - CHICAGO MERCANTILE EXCHANGE,2011-01-04,65924,26859,   15983,    6559,128483,   19140,39065
735,JAPANESE YEN - CHICAGO MERCANTILE EXCHANGE,2010-12-28,49941,20300,   15698,   -1414,109343,   19271,29641
736,JAPANESE YEN - CHICAGO MERCANTILE EXCHANGE,2010-12-21,34243,21714,    -753,    -547,90072,   -6038,12529
737,JAPANESE YEN - CHICAGO MERCANTILE EXCHANGE,2010-12-14,34996,22261,  -12665,   -2112,96110,  -36123,12735
738,JAPANESE YEN - CHICAGO MERCANTILE EXCHANGE,2010-12-07,47661,24373,   -8130,   -1412,132233,    -836,23288
739,JAPANESE YEN - CHICAGO MERCANTILE EXCHANGE,2010-11-30,55791,25785,    4630,    1816,133069,    3449,30006
740,JAPANESE YEN - CHICAGO MERCANTILE EXCHANGE,2010-11-23,51161,23969,    3566,    -768,129620,   -2081,27192
741,JAPANESE YEN - CHICAGO MERCANTILE EXCHANGE,2010-11-16,47595,24737,   -6661,    7135,131701,   -8814,22858
742,JAPANESE YEN - CHICAGO MERCANTILE EXCHANGE,2010-11-09,54256,17602,   -8805,     996,140515,     453,36654
743,JAPANESE YEN - CHICAGO MERCANTILE EXCHANGE,2010-11-02,63061,16606,    1756,   -1570,140062,     212,46455
744,JAPANESE YEN - CHICAGO MERCANTILE EXCHANGE,2010-10-26,61305,18176,   -1249,    1478,139850,     354,43129
745,JAPANESE YEN - CHICAGO MERCANTILE EXCHANGE,2010-10-19,62554,16698,   -3909,   -1480,139496,   -7085,45856
746,JAPANESE YEN - CHICAGO MERCANTILE EXCHANGE,2010-10-12,66463,18178,    -403,     518,146581,    4093,48285
747,JAPANESE YEN - CHICAGO MERCANTILE EXCHANGE,2010-10-05,66866,17660,   21730,    1190,142488,   24214,49206
748,JAPANESE YEN - CHICAGO MERCANTILE EXCHANGE,2010-09-28,45136,16470,    5188,    -378,118274,    4925,28666
749,JAPANESE YEN - CHICAGO MERCANTILE EXCHANGE,2010-09-21,39948,16848,  -21267,    3275,113349,  -21011,23100
750,JAPANESE YEN - CHICAGO MERCANTILE EXCHANGE,2010-09-14,61215,13573,   -4225,     316,134360,  -16153,47642
751,JAPANESE YEN - CHICAGO MERCANTILE EXCHANGE,2010-09-07,65440,13257,    4221,    1942,150513,   11434,52183
752,JAPANESE YEN - CHICAGO MERCANTILE EXCHANGE,2010-08-31,61219,11315,   -1867,    -702,139079,   -1049,49904
753,JAPANESE YEN - CHICAGO MERCANTILE EXCHANGE,2010-08-24,63086,12017,     341,    -759,140128,    2483,51069
754,JAPANESE YEN - CHICAGO MERCANTILE EXCHANGE,2010-08-17,62745,12776,   -2569,     -60,137645,     646,49969
755,JAPANESE YEN - CHICAGO MERCANTILE EXCHANGE,2010-08-10,65314,12836,    3591,    -889,136999,    3129,52478
756,JAPANESE YEN - CHICAGO MERCANTILE EXCHANGE,2010-08-03,61723,13725,   13235,   -4842,133870,    9275,47998
757,JAPANESE YEN - CHICAGO MERCANTILE EXCHANGE,2010-07-27,48488,18567,   -6245,    4745,124595,   -3063,29921
758,JAPANESE YEN - CHICAGO MERCANTILE EXCHANGE,2010-07-20,54733,13822,   -8472,   -2024,127658,   -6007,40911
759,JAPANESE YEN - CHICAGO MERCANTILE EXCHANGE,2010-07-13,63205,15846,     729,   -8704,133665,   -1463,47359
760,JAPANESE YEN - CHICAGO MERCANTILE EXCHANGE,2010-07-06,62476,24550,   10755,     256,135128,   14644,37926
761,JAPANESE YEN - CHICAGO MERCANTILE EXCHANGE,2010-06-29,51721,24294,   22464,   -1333,120484,   29069,27427
762,JAPANESE YEN - CHICAGO MERCANTILE EXCHANGE,2010-06-22,29257,25627,    5953,   -1357,91415,    9198,3630
763,JAPANESE YEN - CHICAGO MERCANTILE EXCHANGE,2010-06-15,23304,26984,   -5215,  -14082,82217,  -50793,-3680
764,JAPANESE YEN - CHICAGO MERCANTILE EXCHANGE,2010-06-08,28519,41066,   -4696,    1367,133010,    -355,-12547
765,JAPANESE YEN - CHICAGO MERCANTILE EXCHANGE,2010-06-01,33215,39699,    1221,   -2533,133365,   -7404,-6484
766,JAPANESE YEN - CHICAGO MERCANTILE EXCHANGE,2010-05-25,31994,42232,   10601,  -13450,140769,   -1930,-10238
767,JAPANESE YEN - CHICAGO MERCANTILE EXCHANGE,2010-05-18,21393,55682,   -1872,   -2252,142699,   -3690,-34289
768,JAPANESE YEN - CHICAGO MERCANTILE EXCHANGE,2010-05-11,23265,57934,   10835,  -20108,146389,    -854,-34669
769,JAPANESE YEN - CHICAGO MERCANTILE EXCHANGE,2010-05-04,12430,78042,   -2588,   13247,147243,    9463,-65612
770,JAPANESE YEN - CHICAGO MERCANTILE EXCHANGE,2010-04-27,15018,64795,     807,     246,137780,    3456,-49777
771,JAPANESE YEN - CHICAGO MERCANTILE EXCHANGE,2010-04-20,14211,64549,    1638,   -3770,134324,    2601,-50338
772,JAPANESE YEN - CHICAGO MERCANTILE EXCHANGE,2010-04-13,12573,68319,   -6023,    7418,131723,    7886,-55746
773,JAPANESE YEN - CHICAGO MERCANTILE EXCHANGE,2010-04-06,18596,60901,    1422,   12861,123837,   14420,-42305
774,JAPANESE YEN - CHICAGO MERCANTILE EXCHANGE,2010-03-30,17174,48040,  -23856,   17171,109417,   12504,-30866
775,JAPANESE YEN - CHICAGO MERCANTILE EXCHANGE,2010-03-23,41030,30869,    -248,    4788,96913,     914,10161
776,JAPANESE YEN - CHICAGO MERCANTILE EXCHANGE,2010-03-16,41278,26081,  -10641,     450,95999,  -41444,15197
777,JAPANESE YEN - CHICAGO MERCANTILE EXCHANGE,2010-03-09,51919,25631,   -5413,     851,137443,    3843,26288
778,JAPANESE YEN - CHICAGO MERCANTILE EXCHANGE,2010-03-02,57332,24780,   26900,   -3935,133600,   10681,32552
779,JAPANESE YEN - CHICAGO MERCANTILE EXCHANGE,2010-02-23,30432,28715,   -5259,    6936,122919,    3103,1717
780,JAPANESE YEN - CHICAGO MERCANTILE EXCHANGE,2010-02-16,35691,21779,   -5661,    2823,119816,    -244,13912
781,JAPANESE YEN - CHICAGO MERCANTILE EXCHANGE,2010-02-09,41352,18956,   11175,   -4086,120060,    3931,22396
782,JAPANESE YEN - CHICAGO MERCANTILE EXCHANGE,2010-02-02,30177,23042,    1356,  -10126,116129,   -3690,7135
783,JAPANESE YEN - CHICAGO MERCANTILE EXCHANGE,2010-01-26,28821,33168,    5103,   -7646,119819,   -2548,-4347
784,JAPANESE YEN - CHICAGO MERCANTILE EXCHANGE,2010-01-19,23718,40814,    1767,    2119,122367,    1799,-17096
785,JAPANESE YEN - CHICAGO MERCANTILE EXCHANGE,2010-01-12,21951,38695,    1317,    1250,120568,   16337,-16744
786,JAPANESE YEN - CHICAGO MERCANTILE EXCHANGE,2010-01-05,20634,37445,     691,    2599,104231,    9014,-16811
787,JAPANESE YEN - CHICAGO MERCANTILE EXCHANGE,2009-12-29,19943,34846,   -9534,    4358,95217,    1993,-14903
788,JAPANESE YEN - CHICAGO MERCANTILE EXCHANGE,2009-12-22,29477,30488,   -4333,    5050,93224,    4786,-1011
789,JAPANESE YEN - CHICAGO MERCANTILE EXCHANGE,2009-12-15,33810,25438,  -14944,   11866,88438,  -35063,8372
790,JAPANESE YEN - CHICAGO MERCANTILE EXCHANGE,2009-12-08,48754,13572,  -25039,   -3314,123501,  -20622,35182
791,JAPANESE YEN - CHICAGO MERCANTILE EXCHANGE,2009-12-01,73793,16886,    8569,    3372,144123,   12290,56907
792,JAPANESE YEN - CHICAGO MERCANTILE EXCHANGE,2009-11-24,65224,13514,   16474,     316,131833,    5925,51710
793,JAPANESE YEN - CHICAGO MERCANTILE EXCHANGE,2009-11-17,48750,13198,    6706,   -6968,125908,    8564,35552
794,JAPANESE YEN - CHICAGO MERCANTILE EXCHANGE,2009-11-09,42044,20166,    3016,     970,117344,    7312,21878
795,JAPANESE YEN - CHICAGO MERCANTILE EXCHANGE,2009-11-03,39028,19196,    2952,     650,110032,   -5129,19832
796,JAPANESE YEN - CHICAGO MERCANTILE EXCHANGE,2009-10-27,36076,18546,  -13325,     330,115161,   -5469,17530
797,JAPANESE YEN - CHICAGO MERCANTILE EXCHANGE,2009-10-20,49401,18216,    -416,    1738,120630,    1578,31185
798,JAPANESE YEN - CHICAGO MERCANTILE EXCHANGE,2009-10-13,49817,16478,  -12310,   -1006,119052,   -1288,33339
799,JAPANESE YEN - CHICAGO MERCANTILE EXCHANGE,2009-10-06,62127,17484,   -1322,   -1109,120340,    1064,44643
800,JAPANESE YEN - CHICAGO MERCANTILE EXCHANGE,2009-09-29,63449,18593,     180,     939,119276,    -149,44856
801,JAPANESE YEN - CHICAGO MERCANTILE EXCHANGE,2009-09-22,63269,17654,    9225,     717,119425,   11095,45615
802,JAPANESE YEN - CHICAGO MERCANTILE EXCHANGE,2009-09-15,54044,16937,   -2681,    1011,108330,   -6919,37107
803,JAPANESE YEN - CHICAGO MERCANTILE EXCHANGE,2009-09-08,56725,15926,    4684,   -3750,115249,    7644,40799
804,JAPANESE YEN - CHICAGO MERCANTILE EXCHANGE,2009-09-01,52041,19676,   17986,   -2732,107605,   21105,32365
805,JAPANESE YEN - CHICAGO MERCANTILE EXCHANGE,2009-08-25,34055,22408,    8934,    -360,86500,   13858,11647
806,JAPANESE YEN - CHICAGO MERCANTILE EXCHANGE,2009-08-18,25121,22768,    1102,    -427,72642,    1988,2353
807,JAPANESE YEN - CHICAGO MERCANTILE EXCHANGE,2009-08-11,24019,23195,   -4250,    5541,70654,   -9447,824
808,JAPANESE YEN - CHICAGO MERCANTILE EXCHANGE,2009-08-04,28269,17654,   -9065,    4622,80101,  -10548,10615
809,JAPANESE YEN - CHICAGO MERCANTILE EXCHANGE,2009-07-28,37334,13032,  -15639,   -3753,90649,  -19961,24302
810,JAPANESE YEN - CHICAGO MERCANTILE EXCHANGE,2009-07-21,52973,16785,     333,   -2288,110610,     470,36188
811,JAPANESE YEN - CHICAGO MERCANTILE EXCHANGE,2009-07-14,52640,19073,   15972,    -478,110140,   20184,33567
812,JAPANESE YEN - CHICAGO MERCANTILE EXCHANGE,2009-07-07,36668,19551,   13407,   -4757,89956,   16480,17117
813,JAPANESE YEN - CHICAGO MERCANTILE EXCHANGE,2009-06-30,23261,24308,    1075,   -1885,73476,    -321,-1047
814,JAPANESE YEN - CHICAGO MERCANTILE EXCHANGE,2009-06-23,22186,26193,    3899,    -657,73797,   10799,-4007
815,JAPANESE YEN - CHICAGO MERCANTILE EXCHANGE,2009-06-16,18287,26850,   -6935,    -671,62998,  -30529,-8563
816,JAPANESE YEN - CHICAGO MERCANTILE EXCHANGE,2009-06-09,25222,27521,   -8855,    3065,93527,   -3442,-2299
817,JAPANESE YEN - CHICAGO MERCANTILE EXCHANGE,2009-06-02,34077,24456,    -783,   -2395,96969,     263,9621
818,JAPANESE YEN - CHICAGO MERCANTILE EXCHANGE,2009-05-26,34860,26851,    5334,    3325,96706,    6502,8009
819,JAPANESE YEN - CHICAGO MERCANTILE EXCHANGE,2009-05-19,29526,23526,    1013,   -2599,90204,    4495,6000
820,JAPANESE YEN - CHICAGO MERCANTILE EXCHANGE,2009-05-12,28513,26125,    6925,   -1981,85709,   10114,2388
821,JAPANESE YEN - CHICAGO MERCANTILE EXCHANGE,2009-05-05,21588,28106,    -574,    1365,75595,    -139,-6518
822,JAPANESE YEN - CHICAGO MERCANTILE EXCHANGE,2009-04-28,22162,26741,    3819,   -5297,75734,    1519,-4579
823,JAPANESE YEN - CHICAGO MERCANTILE EXCHANGE,2009-04-21,18343,32038,   -2826,    4774,74215,   -7802,-13695
824,JAPANESE YEN - CHICAGO MERCANTILE EXCHANGE,2009-04-14,21169,27264,   -4397,   -5300,82017,   -2121,-6095
825,JAPANESE YEN - CHICAGO MERCANTILE EXCHANGE,2009-04-07,25566,32564,   -1178,   -3643,84138,    7531,-6998
826,JAPANESE YEN - CHICAGO MERCANTILE EXCHANGE,2009-03-31,26744,36207,    1687,    3488,76607,    6684,-9463
827,JAPANESE YEN - CHICAGO MERCANTILE EXCHANGE,2009-03-24,25057,32719,   -2113,     853,69923,    -584,-7662
828,JAPANESE YEN - CHICAGO MERCANTILE EXCHANGE,2009-03-17,27170,31866,  -16156,    7446,70507,  -43513,-4696
829,JAPANESE YEN - CHICAGO MERCANTILE EXCHANGE,2009-03-10,43326,24420,   -3292,   -2128,114020,    3797,18906
830,JAPANESE YEN - CHICAGO MERCANTILE EXCHANGE,2009-03-03,46618,26548,    -644,    7921,110223,    1518,20070
831,JAPANESE YEN - CHICAGO MERCANTILE EXCHANGE,2009-02-24,47262,18627,   -7391,     162,108705,      20,28635
832,JAPANESE YEN - CHICAGO MERCANTILE EXCHANGE,2009-02-17,54653,18465,   -2217,    5192,108685,    1934,36188
833,JAPANESE YEN - CHICAGO MERCANTILE EXCHANGE,2009-02-10,56870,13273,   -8261,   -1340,106751,  -10318,43597
834,JAPANESE YEN - CHICAGO MERCANTILE EXCHANGE,2009-02-03,65131,14613,    1762,     251,117069,    2006,50518
835,JAPANESE YEN - CHICAGO MERCANTILE EXCHANGE,2009-01-27,63369,14362,     840,   -1077,115063,    1892,49007
836,JAPANESE YEN - CHICAGO MERCANTILE EXCHANGE,2009-01-20,62529,15439,    2049,    -146,113171,    5457,47090
837,JAPANESE YEN - CHICAGO MERCANTILE EXCHANGE,2009-01-13,60480,15585,   -2135,    -636,107714,   -2446,44895
838,JAPANESE YEN - CHICAGO MERCANTILE EXCHANGE,2009-01-06,62615,16221,    4822,    2304,110160,    4234,46394
839,JAPANESE YEN - CHICAGO MERCANTILE EXCHANGE,2008-12-30,57793,13917,    1459,   -2319,105926,     587,43876
840,JAPANESE YEN - CHICAGO MERCANTILE EXCHANGE,2008-12-22,56334,16236,   -3651,   -2368,105339,   -5133,40098
841,JAPANESE YEN - CHICAGO MERCANTILE EXCHANGE,2008-12-16,59985,18604,   -2993,   -1115,110472,  -55587,41381
842,JAPANESE YEN - CHICAGO MERCANTILE EXCHANGE,2008-12-09,62978,19719,   -4765,   -5121,166059,   27065,43259
843,JAPANESE YEN - CHICAGO MERCANTILE EXCHANGE,2008-12-02,67743,24840,    5677,     -60,138994,    7788,42903
844,JAPANESE YEN - CHICAGO MERCANTILE EXCHANGE,2008-11-25,62066,24900,   15239,    2207,131206,    1512,37166
845,JAPANESE YEN - CHICAGO MERCANTILE EXCHANGE,2008-11-18,46827,22693,     474,     851,129694,    -408,24134
846,JAPANESE YEN - CHICAGO MERCANTILE EXCHANGE,2008-11-11,46353,21842,    -419,    1564,130102,     602,24511
847,JAPANESE YEN - CHICAGO MERCANTILE EXCHANGE,2008-11-04,46772,20278,   -4443,     889,129500,  -13520,26494
848,JAPANESE YEN - CHICAGO MERCANTILE EXCHANGE,2008-10-28,51215,19389,    -226,   -1931,143020,    4252,31826
849,JAPANESE YEN - CHICAGO MERCANTILE EXCHANGE,2008-10-21,51441,21320,    -268,    -485,138768,    5785,30121
850,JAPANESE YEN - CHICAGO MERCANTILE EXCHANGE,2008-10-14,51709,21805,   -9848,      61,132983,  -25020,29904
851,JAPANESE YEN - CHICAGO MERCANTILE EXCHANGE,2008-10-07,61557,21744,   -7816,   -4607,158003,   -1905,39813
852,JAPANESE YEN - CHICAGO MERCANTILE EXCHANGE,2008-09-30,69373,26351,   18187,    7104,159908,   18231,43022
853,JAPANESE YEN - CHICAGO MERCANTILE EXCHANGE,2008-09-23,51186,19247,     561,   -4778,141677,    9544,31939
854,JAPANESE YEN - CHICAGO MERCANTILE EXCHANGE,2008-09-16,50625,24025,   11327,    -452,132133,  -74783,26600
855,JAPANESE YEN - CHICAGO MERCANTILE EXCHANGE,2008-09-09,39298,24477,     893,  -18948,206916,    1103,14821
856,JAPANESE YEN - CHICAGO MERCANTILE EXCHANGE,2008-09-02,38405,43425,   -1698,  -16648,205813,   -3325,-5020
857,JAPANESE YEN - CHICAGO MERCANTILE EXCHANGE,2008-08-26,40103,60073,    -830,   -3998,209138,   -3844,-19970
858,JAPANESE YEN - CHICAGO MERCANTILE EXCHANGE,2008-08-19,40933,64071,   -5231,    4658,212982,    4360,-23138
859,JAPANESE YEN - CHICAGO MERCANTILE EXCHANGE,2008-08-12,46164,59413,     266,    1434,208622,    7804,-13249
860,JAPANESE YEN - CHICAGO MERCANTILE EXCHANGE,2008-08-05,45898,57979,    6736,   12537,200818,   21859,-12081
861,JAPANESE YEN - CHICAGO MERCANTILE EXCHANGE,2008-07-29,39162,45442,   -9271,    7533,178959,   -8826,-6280
862,JAPANESE YEN - CHICAGO MERCANTILE EXCHANGE,2008-07-22,48433,37909,  -29167,   10414,187785,  -26207,10524
863,JAPANESE YEN - CHICAGO MERCANTILE EXCHANGE,2008-07-15,77600,27495,   37081,   -7699,213992,   38564,50105
864,JAPANESE YEN - CHICAGO MERCANTILE EXCHANGE,2008-07-08,40519,35194,   -4670,    6010,175428,    -170,5325
865,JAPANESE YEN - CHICAGO MERCANTILE EXCHANGE,2008-07-01,45189,29184,   10873,  -17879,175598,   11583,16005
866,JAPANESE YEN - CHICAGO MERCANTILE EXCHANGE,2008-06-24,34316,47063,   -5673,   12931,164015,    2471,-12747
867,JAPANESE YEN - CHICAGO MERCANTILE EXCHANGE,2008-06-17,39989,34132,   -3402,   -1543,161544,  -40828,5857
868,JAPANESE YEN - CHICAGO MERCANTILE EXCHANGE,2008-06-10,43391,35675,  -11618,    4031,202372,   37918,7716
869,JAPANESE YEN - CHICAGO MERCANTILE EXCHANGE,2008-06-03,55009,31644,   -7898,    2041,164454,   -7234,23365
870,JAPANESE YEN - CHICAGO MERCANTILE EXCHANGE,2008-05-27,62907,29603,   -2296,    4448,171688,    6300,33304
871,JAPANESE YEN - CHICAGO MERCANTILE EXCHANGE,2008-05-20,65203,25155,    2994,   -3238,165388,   -9035,40048
872,JAPANESE YEN - CHICAGO MERCANTILE EXCHANGE,2008-05-13,62209,28393,   -7146,    7773,174423,    5325,33816
873,JAPANESE YEN - CHICAGO MERCANTILE EXCHANGE,2008-05-06,69355,20620,   -4130,    2585,169098,    2158,48735
874,JAPANESE YEN - CHICAGO MERCANTILE EXCHANGE,2008-04-29,73485,18035,   13132,   -7231,166940,   -5797,55450
875,JAPANESE YEN - CHICAGO MERCANTILE EXCHANGE,2008-04-22,60353,25266,   -8597,    4288,172737,   -4777,35087
876,JAPANESE YEN - CHICAGO MERCANTILE EXCHANGE,2008-04-15,68950,20978,   -1474,   -6379,177514,   -4977,47972
877,JAPANESE YEN - CHICAGO MERCANTILE EXCHANGE,2008-04-08,70424,27357,   -7711,    1520,182491,   -6715,43067
878,JAPANESE YEN - CHICAGO MERCANTILE EXCHANGE,2008-04-01,78135,25837,  -10556,    3066,189206,   -7410,52298
879,JAPANESE YEN - CHICAGO MERCANTILE EXCHANGE,2008-03-25,88691,22771,    6391,   -3770,196616,    3036,65920
880,JAPANESE YEN - CHICAGO MERCANTILE EXCHANGE,2008-03-18,82300,26541,   -4083,   -9689,193580,  -40489,55759
881,JAPANESE YEN - CHICAGO MERCANTILE EXCHANGE,2008-03-11,86383,36230,   -8271,   -2139,234069,  -20790,50153
882,JAPANESE YEN - CHICAGO MERCANTILE EXCHANGE,2008-03-04,94654,38369,   24466,    2470,254859,   19003,56285
883,JAPANESE YEN - CHICAGO MERCANTILE EXCHANGE,2008-02-26,70188,35899,  -10617,    5538,235856,   -1367,34289
884,JAPANESE YEN - CHICAGO MERCANTILE EXCHANGE,2008-02-19,80805,30361,    6850,    -123,237223,    6007,50444
885,JAPANESE YEN - CHICAGO MERCANTILE EXCHANGE,2008-02-12,73955,30484,   -9785,    1434,231216,    5926,43471
886,JAPANESE YEN - CHICAGO MERCANTILE EXCHANGE,2008-02-05,83740,29050,    4930,    3168,225290,   19128,54690
887,JAPANESE YEN - CHICAGO MERCANTILE EXCHANGE,2008-01-29,78810,25882,   10914,    -172,206162,   12854,52928
888,JAPANESE YEN - CHICAGO MERCANTILE EXCHANGE,2008-01-22,67896,26054,    3184,   -1459,193308,   -9240,41842
889,JAPANESE YEN - CHICAGO MERCANTILE EXCHANGE,2008-01-15,64712,27513,    2356,    2630,202548,    8762,37199
890,JAPANESE YEN - CHICAGO MERCANTILE EXCHANGE,2008-01-08,62356,24883,   17249,  -19304,193786,   12374,37473
891,JAPANESE YEN - CHICAGO MERCANTILE EXCHANGE,2007-12-31,45107,44187,   -1854,    1239,181412,    1379,920
892,JAPANESE YEN - CHICAGO MERCANTILE EXCHANGE,2007-12-24,46961,42948,   -7114,    2230,180033,    3413,4013
893,JAPANESE YEN - CHICAGO MERCANTILE EXCHANGE,2007-12-18,54075,40718,  -14482,    3064,176620,  -41994,13357
894,JAPANESE YEN - CHICAGO MERCANTILE EXCHANGE,2007-12-11,68557,37654,   -4906,   -1724,218614,   22853,30903
895,JAPANESE YEN - CHICAGO MERCANTILE EXCHANGE,2007-12-04,73463,39378,    5359,    2606,195761,    3187,34085
896,JAPANESE YEN - CHICAGO MERCANTILE EXCHANGE,2007-11-27,68104,36772,      84,    -847,192574,    -635,31332
897,JAPANESE YEN - CHICAGO MERCANTILE EXCHANGE,2007-11-20,68020,37619,    4682,   -4923,193209,    2254,30401
898,JAPANESE YEN - CHICAGO MERCANTILE EXCHANGE,2007-11-13,63338,42542,    3393,  -26300,190955,  -25086,20796
899,JAPANESE YEN - CHICAGO MERCANTILE EXCHANGE,2007-11-06,59945,68842,    2484,    1432,216041,   -5961,-8897
900,JAPANESE YEN - CHICAGO MERCANTILE EXCHANGE,2007-10-30,57461,67410,   11092,    -313,222002,   -3030,-9949
901,JAPANESE YEN - CHICAGO MERCANTILE EXCHANGE,2007-10-23,46369,67723,     762,  -16497,225032,   -3302,-21354
902,JAPANESE YEN - CHICAGO MERCANTILE EXCHANGE,2007-10-16,45607,84220,    9286,    2142,228334,    3987,-38613
903,JAPANESE YEN - CHICAGO MERCANTILE EXCHANGE,2007-10-09,36321,82078,     800,   18488,224347,   27287,-45757
904,JAPANESE YEN - CHICAGO MERCANTILE EXCHANGE,2007-10-02,35521,63590,  -10530,   15090,197060,   25290,-28069
905,JAPANESE YEN - CHICAGO MERCANTILE EXCHANGE,2007-09-25,46051,48500,    4517,  -14101,171770,    3581,-2449
906,JAPANESE YEN - CHICAGO MERCANTILE EXCHANGE,2007-09-18,41534,62601,  -21199,    5453,168189, -131349,-21067
907,JAPANESE YEN - CHICAGO MERCANTILE EXCHANGE,2007-09-11,62733,57148,    4394,   -8244,299538,   29704,5585
908,JAPANESE YEN - CHICAGO MERCANTILE EXCHANGE,2007-09-04,58339,65392,   -7789,    9110,269834,   -7161,-7053
909,JAPANESE YEN - CHICAGO MERCANTILE EXCHANGE,2007-08-28,66128,56282,    4910,   -3420,276995,    3987,9846
910,JAPANESE YEN - CHICAGO MERCANTILE EXCHANGE,2007-08-21,61218,59702,    3459,  -19946,273008,   -5390,1516
911,JAPANESE YEN - CHICAGO MERCANTILE EXCHANGE,2007-08-14,57759,79648,   10649,   -1955,278398,   14493,-21889
912,JAPANESE YEN - CHICAGO MERCANTILE EXCHANGE,2007-08-07,47110,81603,     510,  -16159,263905,    -366,-34493
913,JAPANESE YEN - CHICAGO MERCANTILE EXCHANGE,2007-07-31,46600,97762,   -4488,  -45741,264271,  -20398,-51162
914,JAPANESE YEN - CHICAGO MERCANTILE EXCHANGE,2007-07-24,51088,143503,     657,  -33701,284669,  -18926,-92415
915,JAPANESE YEN - CHICAGO MERCANTILE EXCHANGE,2007-07-17,50431,177204,   -1118,    -235,303595,  -16738,-126773
916,JAPANESE YEN - CHICAGO MERCANTILE EXCHANGE,2007-07-10,51549,177439,    8176,  -21072,320333,   -6478,-125890
917,JAPANESE YEN - CHICAGO MERCANTILE EXCHANGE,2007-07-03,43373,198511,   -6038,  -38977,326811,  -25488,-155138
918,JAPANESE YEN - CHICAGO MERCANTILE EXCHANGE,2007-06-26,49411,237488,    4193,   30909,352299,   42216,-188077
919,JAPANESE YEN - CHICAGO MERCANTILE EXCHANGE,2007-06-19,45218,206579,   -3573,   30226,310083,  -70449,-161361
920,JAPANESE YEN - CHICAGO MERCANTILE EXCHANGE,2007-06-12,48791,176353,   -4990,   -1434,380532,   69244,-127562
921,JAPANESE YEN - CHICAGO MERCANTILE EXCHANGE,2007-06-05,53781,177787,    2480,  -19757,311288,   -7760,-124006
922,JAPANESE YEN - CHICAGO MERCANTILE EXCHANGE,2007-05-29,51301,197544,   -1000,   -6503,319048,   -7383,-146243
923,JAPANESE YEN - CHICAGO MERCANTILE EXCHANGE,2007-05-22,52301,204047,    5651,   29501,326431,   29168,-151746
924,JAPANESE YEN - CHICAGO MERCANTILE EXCHANGE,2007-05-15,46650,174546,   -4563,   11074,297263,   12483,-127896
925,JAPANESE YEN - CHICAGO MERCANTILE EXCHANGE,2007-05-08,51213,163472,    3595,   -2928,284780,    4912,-112259
926,JAPANESE YEN - CHICAGO MERCANTILE EXCHANGE,2007-05-01,47618,166400,    9718,   46728,279868,   44337,-118782
927,JAPANESE YEN - CHICAGO MERCANTILE EXCHANGE,2007-04-24,37900,119672,   -5381,    5872,235531,     735,-81772
928,JAPANESE YEN - CHICAGO MERCANTILE EXCHANGE,2007-04-17,43281,113800,     563,    6241,234796,    4426,-70519
929,JAPANESE YEN - CHICAGO MERCANTILE EXCHANGE,2007-04-10,42718,107559,    5873,    6856,230370,    8622,-64841
930,JAPANESE YEN - CHICAGO MERCANTILE EXCHANGE,2007-04-03,36845,100703,    -920,   15458,221748,   17675,-63858
931,JAPANESE YEN - CHICAGO MERCANTILE EXCHANGE,2007-03-27,37765,85245,    3496,    1023,204073,   27523,-47480
932,JAPANESE YEN - CHICAGO MERCANTILE EXCHANGE,2007-03-20,34269,84222,   -3925,   -6825,176550, -105052,-49953
933,JAPANESE YEN - CHICAGO MERCANTILE EXCHANGE,2007-03-13,38194,91047,    7715,   -2318,281602,    3111,-52853
934,JAPANESE YEN - CHICAGO MERCANTILE EXCHANGE,2007-03-06,30479,93365,   -8904,  -60644,278491,  -49804,-62886
935,JAPANESE YEN - CHICAGO MERCANTILE EXCHANGE,2007-02-27,39383,154009,   -2903,   -4472,328295,   -3921,-114626
936,JAPANESE YEN - CHICAGO MERCANTILE EXCHANGE,2007-02-20,42286,158481,   -1181,  -52491,332216,  -29593,-116195
937,JAPANESE YEN - CHICAGO MERCANTILE EXCHANGE,2007-02-13,43467,210972,    2442,   41421,361809,   46889,-167505
938,JAPANESE YEN - CHICAGO MERCANTILE EXCHANGE,2007-02-06,41025,169551,   -1554,  -46033,314920,  -29150,-128526
939,JAPANESE YEN - CHICAGO MERCANTILE EXCHANGE,2007-01-30,42579,215584,   -9621,   -1476,344070,    -928,-173005
940,JAPANESE YEN - CHICAGO MERCANTILE EXCHANGE,2007-01-23,52200,217060,   -3831,   22883,344998,   36258,-164860
941,JAPANESE YEN - CHICAGO MERCANTILE EXCHANGE,2007-01-16,56031,194177,    1690,   16493,308740,   20741,-138146
942,JAPANESE YEN - CHICAGO MERCANTILE EXCHANGE,2007-01-09,54341,177684,    -478,    4273,287999,    7458,-123343
943,JAPANESE YEN - CHICAGO MERCANTILE EXCHANGE,2007-01-03,54819,173411,    -810,   12868,280541,   17777,-118592
944,JAPANESE YEN - CHICAGO MERCANTILE EXCHANGE,2006-12-26,55629,160543,    6679,   19074,262764,   23722,-104914
945,JAPANESE YEN - CHICAGO MERCANTILE EXCHANGE,2006-12-19,48950,141469,   -1672,   35287,239042,  -37877,-92519
946,JAPANESE YEN - CHICAGO MERCANTILE EXCHANGE,2006-12-12,50622,106182,  -11722,   20301,276919,    8783,-55560
947,JAPANESE YEN - CHICAGO MERCANTILE EXCHANGE,2006-12-05,62344,85881,    6311,  -12110,268136,   16029,-23537
948,JAPANESE YEN - CHICAGO MERCANTILE EXCHANGE,2006-11-28,56033,97991,    5385,  -33078,252107,   -6220,-41958
949,JAPANESE YEN - CHICAGO MERCANTILE EXCHANGE,2006-11-21,50648,131069,    2542,   27951,258327,   24754,-80421
950,JAPANESE YEN - CHICAGO MERCANTILE EXCHANGE,2006-11-14,48106,103118,       4,   -8496,233573,    4510,-55012
951,JAPANESE YEN - CHICAGO MERCANTILE EXCHANGE,2006-11-07,48102,111614,    1326,    5238,229063,    2456,-63512
952,JAPANESE YEN - CHICAGO MERCANTILE EXCHANGE,2006-10-31,46776,106376,   -3625,  -81315,226607,  -56391,-59600
953,JAPANESE YEN - CHICAGO MERCANTILE EXCHANGE,2006-10-24,50401,187691,   -2772,   21940,282998,   21423,-137290
954,JAPANESE YEN - CHICAGO MERCANTILE EXCHANGE,2006-10-17,53173,165751,    2578,   -8442,261575,   -6228,-112578
955,JAPANESE YEN - CHICAGO MERCANTILE EXCHANGE,2006-10-10,50595,174193,    3165,   22612,267803,   23984,-123598
956,JAPANESE YEN - CHICAGO MERCANTILE EXCHANGE,2006-10-03,47430,151581,    4912,   21705,243819,   22579,-104151
957,JAPANESE YEN - CHICAGO MERCANTILE EXCHANGE,2006-09-26,42518,129876,    7563,    4117,221240,   -3858,-87358
958,JAPANESE YEN - CHICAGO MERCANTILE EXCHANGE,2006-09-19,34955,125759,      13,   -8635,225098,  -50487,-90804
959,JAPANESE YEN - CHICAGO MERCANTILE EXCHANGE,2006-09-12,34942,134394,    2001,   31955,275585,   46793,-99452
960,JAPANESE YEN - CHICAGO MERCANTILE EXCHANGE,2006-09-05,32941,102439,    -979,  -19810,228792,  -15649,-69498
961,JAPANESE YEN - CHICAGO MERCANTILE EXCHANGE,2006-08-29,33920,122249,    3067,   16319,244441,   17246,-88329
962,JAPANESE YEN - CHICAGO MERCANTILE EXCHANGE,2006-08-22,30853,105930,    1207,   14010,227195,   10703,-75077
963,JAPANESE YEN - CHICAGO MERCANTILE EXCHANGE,2006-08-15,29646,91920,    4615,   15098,216492,   17922,-62274
964,JAPANESE YEN - CHICAGO MERCANTILE EXCHANGE,2006-08-08,25031,76822,    -360,    8447,198570,    2944,-51791
965,JAPANESE YEN - CHICAGO MERCANTILE EXCHANGE,2006-08-01,25391,68375,    -908,  -34810,195626,  -12882,-42984
966,JAPANESE YEN - CHICAGO MERCANTILE EXCHANGE,2006-07-25,26299,103185,   -1425,    6412,208508,    4941,-76886
967,JAPANESE YEN - CHICAGO MERCANTILE EXCHANGE,2006-07-18,27724,96773,      85,   48430,203567,   30097,-69049
968,JAPANESE YEN - CHICAGO MERCANTILE EXCHANGE,2006-07-11,27639,48343,    2309,    -896,173470,    4782,-20704
969,JAPANESE YEN - CHICAGO MERCANTILE EXCHANGE,2006-07-03,25330,49239,     140,  -11523,168688,   -5378,-23909
970,JAPANESE YEN - CHICAGO MERCANTILE EXCHANGE,2006-06-27,25190,60762,    1313,   13878,174066,   12776,-35572
971,JAPANESE YEN - CHICAGO MERCANTILE EXCHANGE,2006-06-20,23877,46884,  -15483,   -2073,161290,  -82223,-23007
972,JAPANESE YEN - CHICAGO MERCANTILE EXCHANGE,2006-06-13,39360,48957,   -7788,   22812,243513,   41670,-9597
973,JAPANESE YEN - CHICAGO MERCANTILE EXCHANGE,2006-06-06,47148,26145,   -8871,   -4133,201843,   -6669,21003
974,JAPANESE YEN - CHICAGO MERCANTILE EXCHANGE,2006-05-30,56019,30278,    6350,   -1062,208512,   -3437,25741
975,JAPANESE YEN - CHICAGO MERCANTILE EXCHANGE,2006-05-23,49669,31340,    2616,    3408,211949,    -437,18329
976,JAPANESE YEN - CHICAGO MERCANTILE EXCHANGE,2006-05-16,47053,27932,     284,       7,212386,    1841,19121
977,JAPANESE YEN - CHICAGO MERCANTILE EXCHANGE,2006-05-09,46769,27925,    2380,  -13775,210545,    4145,18844
978,JAPANESE YEN - CHICAGO MERCANTILE EXCHANGE,2006-05-02,44389,41700,    3392,   -5787,206400,    4985,2689
979,JAPANESE YEN - CHICAGO MERCANTILE EXCHANGE,2006-04-25,40997,47487,    2248,  -32403,201415,    -624,-6490
980,JAPANESE YEN - CHICAGO MERCANTILE EXCHANGE,2006-04-18,38749,79890,    2536,  -10794,202039,   -3591,-41141
981,JAPANESE YEN - CHICAGO MERCANTILE EXCHANGE,2006-04-11,36213,90684,    5610,   27365,205630,   15898,-54471
982,JAPANESE YEN - CHICAGO MERCANTILE EXCHANGE,2006-04-04,30603,63319,    3374,    5678,189732,    9631,-32716
983,JAPANESE YEN - CHICAGO MERCANTILE EXCHANGE,2006-03-28,27229,57641,    4114,    5170,180101,    4139,-30412
984,JAPANESE YEN - CHICAGO MERCANTILE EXCHANGE,2006-03-21,23115,52471,   -1699,  -17632,175962,  -13551,-29356
985,JAPANESE YEN - CHICAGO MERCANTILE EXCHANGE,2006-03-14,24814,70103,  -11924,   -8466,189513,  -59099,-45289
986,JAPANESE YEN - CHICAGO MERCANTILE EXCHANGE,2006-03-07,36738,78569,   -4849,   14161,248612,   46839,-41831
987,JAPANESE YEN - CHICAGO MERCANTILE EXCHANGE,2006-02-28,41587,64408,   14628,  -33735,201773,   -1692,-22821
988,JAPANESE YEN - CHICAGO MERCANTILE EXCHANGE,2006-02-21,26959,98143,    -601,   15526,203465,    7821,-71184
989,JAPANESE YEN - CHICAGO MERCANTILE EXCHANGE,2006-02-14,27560,82617,   -3659,   -4949,195644,   -2254,-55057
990,JAPANESE YEN - CHICAGO MERCANTILE EXCHANGE,2006-02-07,31219,87566,   -1068,   13534,197898,    9174,-56347
991,JAPANESE YEN - CHICAGO MERCANTILE EXCHANGE,2006-01-31,32287,74032,    2589,   25056,188724,   22124,-41745
992,JAPANESE YEN - CHICAGO MERCANTILE EXCHANGE,2006-01-24,29698,48976,    -364,     655,166600,   -1081,-19278
993,JAPANESE YEN - CHICAGO MERCANTILE EXCHANGE,2006-01-17,30062,48321,    -410,   -1680,167681,   -2205,-18259
994,JAPANESE YEN - CHICAGO MERCANTILE EXCHANGE,2006-01-10,30472,50001,    8280,    3072,169886,   14164,-19529
995,JAPANESE YEN - CHICAGO MERCANTILE EXCHANGE,2006-01-03,22192,46929,    5194,    7802,155722,    6777,-24737
996,JAPANESE YEN - CHICAGO MERCANTILE EXCHANGE,2005-12-27,16998,39127,    4676,     700,148945,    9442,-22129
997,JAPANESE YEN - CHICAGO MERCANTILE EXCHANGE,2005-12-20,12322,38427,   -9899,  -55857,139503, -104096,-26105
998,JAPANESE YEN - CHICAGO MERCANTILE EXCHANGE,2005-12-13,22221,94284,   -4491,   -4071,243599,   23286,-72063
999,JAPANESE YEN - CHICAGO MERCANTILE EXCHANGE,2005-12-06,26712,98355,    4086,   11729,220313,   13435,-71643
1000,JAPANESE YEN - CHICAGO MERCANTILE EXCHANGE,2005-11-29,22626,86626,    1589,    -295,206878,    2062,-64000
1001,JAPANESE YEN - CHICAGO MERCANTILE EXCHANGE,2005-11-22,21037,86921,    -110,   -1457,204816,    1679,-65884
1002,JAPANESE YEN - CHICAGO MERCANTILE EXCHANGE,2005-11-15,21147,88378,    1719,    4322,203137,    5422,-67231
1003,JAPANESE YEN - CHICAGO MERCANTILE EXCHANGE,2005-11-08,19428,84056,    -434,   -2108,197715,    1912,-64628
1004,JAPANESE YEN - CHICAGO MERCANTILE EXCHANGE,2005-11-01,19862,86164,    -236,    -616,195803,     585,-66302
1005,JAPANESE YEN - CHICAGO MERCANTILE EXCHANGE,2005-10-25,20098,86780,    -116,     -75,195218,   -4460,-66682
1006,JAPANESE YEN - CHICAGO MERCANTILE EXCHANGE,2005-10-18,20214,86855,    1469,    2075,199678,   23517,-66641
1007,JAPANESE YEN - CHICAGO MERCANTILE EXCHANGE,2005-10-11,18745,84780,    2393,    5129,176161,    8182,-66035
1008,JAPANESE YEN - CHICAGO MERCANTILE EXCHANGE,2005-10-04,16352,79651,    2883,    7116,167979,   29408,-63299
1009,JAPANESE YEN - CHICAGO MERCANTILE EXCHANGE,2005-09-27,13469,72535,    1515,   12952,138571,   10721,-59066
1010,JAPANESE YEN - CHICAGO MERCANTILE EXCHANGE,2005-09-20,11954,59583,    1674,   14369,127850,  -61397,-47629
1011,JAPANESE YEN - CHICAGO MERCANTILE EXCHANGE,2005-09-13,10280,45214,    2263,    2825,189247,   13261,-34934
1012,JAPANESE YEN - CHICAGO MERCANTILE EXCHANGE,2005-09-06,8017,42389,      76,  -13217,175986,   -2259,-34372
1013,JAPANESE YEN - CHICAGO MERCANTILE EXCHANGE,2005-08-30,7941,55606,   -1417,   14882,178245,   11707,-47665
1014,JAPANESE YEN - CHICAGO MERCANTILE EXCHANGE,2005-08-23,9358,40724,   -3065,    1916,166538,    -385,-31366
1015,JAPANESE YEN - CHICAGO MERCANTILE EXCHANGE,2005-08-16,12423,38808,    -345,  -22620,166923,  -11071,-26385
1016,JAPANESE YEN - CHICAGO MERCANTILE EXCHANGE,2005-08-09,12768,61428,    3431,    8940,177994,   12713,-48660
1017,JAPANESE YEN - CHICAGO MERCANTILE EXCHANGE,2005-08-02,9337,52488,    1305,   -3312,165281,    4267,-43151
1018,JAPANESE YEN - CHICAGO MERCANTILE EXCHANGE,2005-07-26,8032,55800,   -1133,  -12421,161014,   -7683,-47768
1019,JAPANESE YEN - CHICAGO MERCANTILE EXCHANGE,2005-07-19,9165,68221,   -1665,   -5685,168697,    5738,-59056
1020,JAPANESE YEN - CHICAGO MERCANTILE EXCHANGE,2005-07-12,10830,73906,    -749,   10141,162959,    6442,-63076
1021,JAPANESE YEN - CHICAGO MERCANTILE EXCHANGE,2005-07-05,11579,63765,     735,    1076,156517,    8645,-52186
1022,JAPANESE YEN - CHICAGO MERCANTILE EXCHANGE,2005-06-28,10844,62689,    -284,   13587,147872,    8146,-51845
1023,JAPANESE YEN - CHICAGO MERCANTILE EXCHANGE,2005-06-21,11128,49102,    2137,  -11920,139726,   -4322,-37974
1024,JAPANESE YEN - CHICAGO MERCANTILE EXCHANGE,2005-06-14,8991,61022,    3696,   18616,144048,  -41940,-52031
1025,JAPANESE YEN - CHICAGO MERCANTILE EXCHANGE,2005-06-07,5295,42406,   -1172,  -12496,185988,    2395,-37111
1026,JAPANESE YEN - CHICAGO MERCANTILE EXCHANGE,2005-05-31,6467,54902,   -4162,    5442,183593,    -429,-48435
1027,JAPANESE YEN - CHICAGO MERCANTILE EXCHANGE,2005-05-24,10629,49460,   -1034,  -10086,184022,   -5010,-38831
1028,JAPANESE YEN - CHICAGO MERCANTILE EXCHANGE,2005-05-17,11663,59546,   -9108,   29212,189032,   28196,-47883
1029,JAPANESE YEN - CHICAGO MERCANTILE EXCHANGE,2005-05-10,20771,30334,   -1061,   -5629,160836,     651,-9563
1030,JAPANESE YEN - CHICAGO MERCANTILE EXCHANGE,2005-05-03,21832,35963,   10617,   -7754,160185,   21397,-14131
1031,JAPANESE YEN - CHICAGO MERCANTILE EXCHANGE,2005-04-26,11215,43717,    4288,  -17907,138788,   -4390,-32502
1032,JAPANESE YEN - CHICAGO MERCANTILE EXCHANGE,2005-04-19,6927,61624,   -5027,    5474,143178,    9950,-54697
1033,JAPANESE YEN - CHICAGO MERCANTILE EXCHANGE,2005-04-12,11954,56150,    2268,   10022,133228,    5822,-44196
1034,JAPANESE YEN - CHICAGO MERCANTILE EXCHANGE,2005-04-05,9686,46128,   -1347,    4906,127406,   13138,-36442
1035,JAPANESE YEN - CHICAGO MERCANTILE EXCHANGE,2005-03-29,11033,41222,   -4642,   13644,114268,    5403,-30189
1036,JAPANESE YEN - CHICAGO MERCANTILE EXCHANGE,2005-03-22,15675,27578,    1731,    8288,108865,    1431,-11903
1037,JAPANESE YEN - CHICAGO MERCANTILE EXCHANGE,2005-03-15,13944,19290,     594,   -3846,107434,  -63675,-5346
1038,JAPANESE YEN - CHICAGO MERCANTILE EXCHANGE,2005-03-08,13350,23136,     -72,    2591,171109,   17478,-9786
1039,JAPANESE YEN - CHICAGO MERCANTILE EXCHANGE,2005-03-01,13422,20545,    -656,  -19468,153631,    -453,-7123
1040,JAPANESE YEN - CHICAGO MERCANTILE EXCHANGE,2005-02-22,14078,40013,    1061,    3303,154084,    2097,-25935
1041,JAPANESE YEN - CHICAGO MERCANTILE EXCHANGE,2005-02-15,13017,36710,   -6781,    2622,151987,   -3565,-23693
1042,JAPANESE YEN - CHICAGO MERCANTILE EXCHANGE,2005-02-08,19798,34088,  -11416,    3273,155552,  -11573,-14290
1043,JAPANESE YEN - CHICAGO MERCANTILE EXCHANGE,2005-02-01,31214,30815,   -2394,   -1869,167125,    4943,399
1044,JAPANESE YEN - CHICAGO MERCANTILE EXCHANGE,2005-01-25,33608,32684,   -6264,     691,162182,   -8927,924
1045,JAPANESE YEN - CHICAGO MERCANTILE EXCHANGE,2005-01-18,39872,31993,    4664,   20530,171109,    9241,7879
1046,JAPANESE YEN - CHICAGO MERCANTILE EXCHANGE,2005-01-11,35208,11463,    1236,     211,161868,    5998,23745
1047,JAPANESE YEN - CHICAGO MERCANTILE EXCHANGE,2005-01-04,33972,11252,   -5268,    -235,155870,    5382,22720
1048,JAPANESE YEN - CHICAGO MERCANTILE EXCHANGE,2004-12-28,39240,11487,    5867,   -1310,150488,    4783,27753
1049,JAPANESE YEN - CHICAGO MERCANTILE EXCHANGE,2004-12-21,33373,12797,    -263,     562,145705,    -273,20576
1050,JAPANESE YEN - CHICAGO MERCANTILE EXCHANGE,2004-12-14,33636,12235,  -17159,   -1237,145978,  -75319,21401
1051,JAPANESE YEN - CHICAGO MERCANTILE EXCHANGE,2004-12-07,50795,13472,  -10481,   -8444,221297,   24337,37323
1052,JAPANESE YEN - CHICAGO MERCANTILE EXCHANGE,2004-11-30,61276,21916,    4578,   -1584,196960,    6588,39360
1053,JAPANESE YEN - CHICAGO MERCANTILE EXCHANGE,2004-11-23,56698,23500,   -1910,    9488,190372,    8471,33198
1054,JAPANESE YEN - CHICAGO MERCANTILE EXCHANGE,2004-11-16,58608,14012,    4851,    -652,181901,    7150,44596
1055,JAPANESE YEN - CHICAGO MERCANTILE EXCHANGE,2004-11-09,53757,14664,    6978,    4699,174751,   12389,39093
1056,JAPANESE YEN - CHICAGO MERCANTILE EXCHANGE,2004-11-02,46779,9965,    5388,   -3790,162362,   18743,36814
1057,JAPANESE YEN - CHICAGO MERCANTILE EXCHANGE,2004-10-26,41391,13755,   18507,    -564,143619,   12698,27636
1058,JAPANESE YEN - CHICAGO MERCANTILE EXCHANGE,2004-10-19,22884,14319,   10131,   -4821,130921,   13635,8565
1059,JAPANESE YEN - CHICAGO MERCANTILE EXCHANGE,2004-10-12,12753,19140,    1181,   -6928,117286,    5978,-6387
1060,JAPANESE YEN - CHICAGO MERCANTILE EXCHANGE,2004-10-05,11572,26068,    1295,   -6412,111308,   16772,-14496
1061,JAPANESE YEN - CHICAGO MERCANTILE EXCHANGE,2004-09-28,10277,32480,    2611,   15457,94536,   12492,-22203
1062,JAPANESE YEN - CHICAGO MERCANTILE EXCHANGE,2004-09-21,7666,17023,    -316,    4984,82044,    2772,-9357
1063,JAPANESE YEN - CHICAGO MERCANTILE EXCHANGE,2004-09-14,7982,12039,   -2865,     360,79272,  -27265,-4057
1064,JAPANESE YEN - CHICAGO MERCANTILE EXCHANGE,2004-09-07,10847,11679,   -1906,    -549,106537,   -2661,-832
1065,JAPANESE YEN - CHICAGO MERCANTILE EXCHANGE,2004-08-31,12753,12228,      -4,   -1498,109198,     638,525
1066,JAPANESE YEN - CHICAGO MERCANTILE EXCHANGE,2004-08-24,12757,13726,    1506,   -2730,108560,   -5397,-969
1067,JAPANESE YEN - CHICAGO MERCANTILE EXCHANGE,2004-08-17,11251,16456,     921,   -2156,113957,    3524,-5205
1068,JAPANESE YEN - CHICAGO MERCANTILE EXCHANGE,2004-08-10,10330,18612,   -1803,    3211,110433,   -3035,-8282
1069,JAPANESE YEN - CHICAGO MERCANTILE EXCHANGE,2004-08-03,12133,15401,    1525,    2392,113468,    6298,-3268
1070,JAPANESE YEN - CHICAGO MERCANTILE EXCHANGE,2004-07-27,10608,13009,   -1181,    3057,107170,   -2151,-2401
1071,JAPANESE YEN - CHICAGO MERCANTILE EXCHANGE,2004-07-20,11789,9952,    1220,    1549,109321,    2931,1837
1072,JAPANESE YEN - CHICAGO MERCANTILE EXCHANGE,2004-07-13,10569,8403,    3081,    3332,106390,    6878,2166
1073,JAPANESE YEN - CHICAGO MERCANTILE EXCHANGE,2004-07-06,7488,5071,   -5774,     225,99512,     608,2417
1074,JAPANESE YEN - CHICAGO MERCANTILE EXCHANGE,2004-06-29,13262,4846,     829,   -2092,98904,    5911,8416
1075,JAPANESE YEN - CHICAGO MERCANTILE EXCHANGE,2004-06-22,12433,6938,     756,   -2246,92993,    1826,5495
1076,JAPANESE YEN - CHICAGO MERCANTILE EXCHANGE,2004-06-15,11677,9184,    -582,   -2477,91167,  -34899,2493
1077,JAPANESE YEN - CHICAGO MERCANTILE EXCHANGE,2004-06-08,12259,11661,    3698,   -1739,126066,   10227,598
1078,JAPANESE YEN - CHICAGO MERCANTILE EXCHANGE,2004-06-01,8561,13400,     -95,   -7363,115839,    8242,-4839
1079,JAPANESE YEN - CHICAGO MERCANTILE EXCHANGE,2004-05-25,8656,20763,    -439,   -1014,107597,    1798,-12107
1080,JAPANESE YEN - CHICAGO MERCANTILE EXCHANGE,2004-05-18,9095,21777,     304,    2893,105799,   -2805,-12682
1081,JAPANESE YEN - CHICAGO MERCANTILE EXCHANGE,2004-05-11,8791,18884,   -3734,    9332,108604,    4743,-10093
1082,JAPANESE YEN - CHICAGO MERCANTILE EXCHANGE,2004-05-04,12525,9552,   -4715,   -7484,103861,   -1117,2973
1083,JAPANESE YEN - CHICAGO MERCANTILE EXCHANGE,2004-04-27,17240,17036,   -1457,   -7705,104978,     738,204
1084,JAPANESE YEN - CHICAGO MERCANTILE EXCHANGE,2004-04-20,18697,24741,  -28320,    2484,104240,  -31148,-6044
1085,JAPANESE YEN - CHICAGO MERCANTILE EXCHANGE,2004-04-12,47017,22257,    3811,    -561,135388,    2537,24760
1086,JAPANESE YEN - CHICAGO MERCANTILE EXCHANGE,2004-04-06,43206,22818,   16955,     876,132851,   25834,20388
1087,JAPANESE YEN - CHICAGO MERCANTILE EXCHANGE,2004-03-30,26251,21942,   14923,   -3987,107017,   20922,4309
1088,JAPANESE YEN - CHICAGO MERCANTILE EXCHANGE,2004-03-23,11328,25929,    4354,  -12484,86095,   -3381,-14601
1089,JAPANESE YEN - CHICAGO MERCANTILE EXCHANGE,2004-03-16,6974,38413,    -805,   -3882,89476,  -67450,-31439
1090,JAPANESE YEN - CHICAGO MERCANTILE EXCHANGE,2004-03-09,7779,42295,   -7940,    4264,156926,    3381,-34516
1091,JAPANESE YEN - CHICAGO MERCANTILE EXCHANGE,2004-03-02,15719,38031,    -483,    9648,153545,   11455,-22312
1092,JAPANESE YEN - CHICAGO MERCANTILE EXCHANGE,2004-02-24,16202,28383,  -45828,   21551,142090,  -17513,-12181
1093,JAPANESE YEN - CHICAGO MERCANTILE EXCHANGE,2004-02-17,62030,6832,   -2565,     867,159603,    -840,55198
1094,JAPANESE YEN - CHICAGO MERCANTILE EXCHANGE,2004-02-10,64595,5965,   -5604,     265,160443,   -9073,58630
1095,JAPANESE YEN - CHICAGO MERCANTILE EXCHANGE,2004-02-03,70199,5700,    6253,    -254,169516,    8803,64499
1096,JAPANESE YEN - CHICAGO MERCANTILE EXCHANGE,2004-01-27,63946,5954,    7145,     861,160713,    8387,57992
1097,JAPANESE YEN - CHICAGO MERCANTILE EXCHANGE,2004-01-20,56801,5093,   -8447,     447,152326,   -6907,51708
1098,JAPANESE YEN - CHICAGO MERCANTILE EXCHANGE,2004-01-13,65248,4646,    2495,   -1273,159233,    2978,60602
1099,JAPANESE YEN - CHICAGO MERCANTILE EXCHANGE,2004-01-06,62753,5919,   10902,    1732,156255,   17832,56834
1100,JAPANESE YEN - CHICAGO MERCANTILE EXCHANGE,2003-12-30,51851,4187,    -469,       2,138423,    7343,47664
1101,JAPANESE YEN - CHICAGO MERCANTILE EXCHANGE,2003-12-22,52320,4185,  -10101,       0,131080,   -8296,48135
1102,JAPANESE YEN - CHICAGO MERCANTILE EXCHANGE,2003-12-16,62421,4185,     -92,   -1592,139376,  -31137,58236
1103,JAPANESE YEN - CHICAGO MERCANTILE EXCHANGE,2003-12-09,62513,5777,    8774,   -1776,170513,   27913,56736
1104,JAPANESE YEN - CHICAGO MERCANTILE EXCHANGE,2003-12-02,53739,7553,    5966,    2320,142600,    9220,46186
1105,JAPANESE YEN - CHICAGO MERCANTILE EXCHANGE,2003-11-25,47773,5233,  -11905,    -683,133380,  -10088,42540
1106,JAPANESE YEN - CHICAGO MERCANTILE EXCHANGE,2003-11-18,59678,5916,   -3907,     128,143468,     105,53762
1107,JAPANESE YEN - CHICAGO MERCANTILE EXCHANGE,2003-11-11,63585,5788,    7406,     -47,143363,    7467,57797
1108,JAPANESE YEN - CHICAGO MERCANTILE EXCHANGE,2003-11-04,56179,5835,  -15283,  -10717,135896,  -16984,50344
1109,JAPANESE YEN - CHICAGO MERCANTILE EXCHANGE,2003-10-28,71462,16552,    1668,   -4938,152880,    1490,54910
1110,JAPANESE YEN - CHICAGO MERCANTILE EXCHANGE,2003-10-21,69794,21490,   -1885,  -10980,151390,   -2886,48304
1111,JAPANESE YEN - CHICAGO MERCANTILE EXCHANGE,2003-10-14,71679,32470,   -4759,    5757,154276,   -4733,39209
1112,JAPANESE YEN - CHICAGO MERCANTILE EXCHANGE,2003-10-07,76438,26713,    6781,   -2079,159009,   14578,49725
1113,JAPANESE YEN - CHICAGO MERCANTILE EXCHANGE,2003-09-30,69657,28792,    8137,   20820,144431,    8931,40865
1114,JAPANESE YEN - CHICAGO MERCANTILE EXCHANGE,2003-09-23,61520,7972,    1367,    2466,135500,    8839,53548
1115,JAPANESE YEN - CHICAGO MERCANTILE EXCHANGE,2003-09-16,60153,5506,     621,   -1181,126661,  -45127,54647
1116,JAPANESE YEN - CHICAGO MERCANTILE EXCHANGE,2003-09-09,59532,6687,    6068,     178,171788,    2204,52845
1117,JAPANESE YEN - CHICAGO MERCANTILE EXCHANGE,2003-09-02,53464,6509,   31316,   -2407,169584,   37846,46955
1118,JAPANESE YEN - CHICAGO MERCANTILE EXCHANGE,2003-08-26,22148,8916,    7591,  -14993,131738,   13694,13232
1119,JAPANESE YEN - CHICAGO MERCANTILE EXCHANGE,2003-08-19,14557,23909,    1617,    1029,118044,    2463,-9352
1120,JAPANESE YEN - CHICAGO MERCANTILE EXCHANGE,2003-08-12,12940,22880,    2804,  -23555,115581,   -9839,-9940
1121,JAPANESE YEN - CHICAGO MERCANTILE EXCHANGE,2003-08-05,10136,46435,   -8444,   34163,125420,   22168,-36299
1122,JAPANESE YEN - CHICAGO MERCANTILE EXCHANGE,2003-07-29,18580,12272,    2044,    2528,103252,    -909,6308
1123,JAPANESE YEN - CHICAGO MERCANTILE EXCHANGE,2003-07-22,16536,9744,   -7166,    1867,104161,   -9808,6792
1124,JAPANESE YEN - CHICAGO MERCANTILE EXCHANGE,2003-07-15,23702,7877,   10060,   -5657,113969,    9535,15825
1125,JAPANESE YEN - CHICAGO MERCANTILE EXCHANGE,2003-07-08,13642,13534,    4874,   -8631,104434,     250,108
1126,JAPANESE YEN - CHICAGO MERCANTILE EXCHANGE,2003-07-01,8768,22165,  -17129,   13404,104184,    5892,-13397
1127,JAPANESE YEN - CHICAGO MERCANTILE EXCHANGE,2003-06-24,25897,8761,    1434,   -4840,98292,    6376,17136
1128,JAPANESE YEN - CHICAGO MERCANTILE EXCHANGE,2003-06-17,24463,13601,    1628,    2522,91916,  -29505,10862
1129,JAPANESE YEN - CHICAGO MERCANTILE EXCHANGE,2003-06-10,22835,11079,    2902,   -1294,121421,   22908,11756
1130,JAPANESE YEN - CHICAGO MERCANTILE EXCHANGE,2003-06-03,19933,12373,  -16825,    5058,98513,  -11330,7560
1131,JAPANESE YEN - CHICAGO MERCANTILE EXCHANGE,2003-05-27,36758,7315,   -1126,    -799,109843,   -2121,29443
1132,JAPANESE YEN - CHICAGO MERCANTILE EXCHANGE,2003-05-20,37884,8114,    -604,    -912,111964,   -2170,29770
1133,JAPANESE YEN - CHICAGO MERCANTILE EXCHANGE,2003-05-13,38488,9026,   18635,   -8159,114134,   14210,29462
1134,JAPANESE YEN - CHICAGO MERCANTILE EXCHANGE,2003-05-06,19853,17185,   10212,   -2636,99924,   13578,2668
1135,JAPANESE YEN - CHICAGO MERCANTILE EXCHANGE,2003-04-29,9641,19821,   -4884,    1113,86346,    2387,-10180
1136,JAPANESE YEN - CHICAGO MERCANTILE EXCHANGE,2003-04-22,14525,18708,    4588,    -646,83959,    4707,-4183
1137,JAPANESE YEN - CHICAGO MERCANTILE EXCHANGE,2003-04-15,9937,19354,   -1094,    2689,79252,    4164,-9417
1138,JAPANESE YEN - CHICAGO MERCANTILE EXCHANGE,2003-04-08,11031,16665,   -1454,     277,75088,   -5048,-5634
1139,JAPANESE YEN - CHICAGO MERCANTILE EXCHANGE,2003-04-01,12485,16388,    1705,   -7375,80136,   -4321,-3903
1140,JAPANESE YEN - CHICAGO MERCANTILE EXCHANGE,2003-03-25,10780,23763,  -19609,   16692,84457,    1798,-12983
1141,JAPANESE YEN - CHICAGO MERCANTILE EXCHANGE,2003-03-18,30389,7071,  -12011,     890,82659,  -50439,23318
1142,JAPANESE YEN - CHICAGO MERCANTILE EXCHANGE,2003-03-11,42400,6181,    1678,   -2509,133098,   16477,36219
1143,JAPANESE YEN - CHICAGO MERCANTILE EXCHANGE,2003-03-04,40722,8690,   -4325,    -603,116621,   -1744,32032
1144,JAPANESE YEN - CHICAGO MERCANTILE EXCHANGE,2003-02-25,45047,9293,    7301,  -10020,118365,    4512,35754
1145,JAPANESE YEN - CHICAGO MERCANTILE EXCHANGE,2003-02-18,37746,19313,    7370,    -354,113853,    3578,18433
1146,JAPANESE YEN - CHICAGO MERCANTILE EXCHANGE,2003-02-11,30376,19667,   10695,    5580,110275,   19027,10709
1147,JAPANESE YEN - CHICAGO MERCANTILE EXCHANGE,2003-02-04,19681,14087,  -16847,    3169,91248,  -17603,5594
1148,JAPANESE YEN - CHICAGO MERCANTILE EXCHANGE,2003-01-28,36528,10918,   -7935,    -252,108851,  -10679,25610
1149,JAPANESE YEN - CHICAGO MERCANTILE EXCHANGE,2003-01-21,44463,11170,      64,    -285,119530,    -866,33293
1150,JAPANESE YEN - CHICAGO MERCANTILE EXCHANGE,2003-01-14,44399,11455,    4911,    -806,120396,    3841,32944
1151,JAPANESE YEN - CHICAGO MERCANTILE EXCHANGE,2003-01-07,39488,12261,   -1178,    -271,116555,   -3126,27227
1152,JAPANESE YEN - CHICAGO MERCANTILE EXCHANGE,2002-12-31,40666,12532,   23690,    -637,119681,   26914,28134
1153,JAPANESE YEN - CHICAGO MERCANTILE EXCHANGE,2002-12-23,16976,13169,    5144,     631,92767,    5591,3807
1154,JAPANESE YEN - CHICAGO MERCANTILE EXCHANGE,2002-12-17,11832,12538,    3626,   -7878,87176,  -32504,-706
1155,JAPANESE YEN - CHICAGO MERCANTILE EXCHANGE,2002-12-10,8206,20416,   -1548,     759,119680,   41247,-12210
1156,JAPANESE YEN - CHICAGO MERCANTILE EXCHANGE,2002-12-03,9754,19657,   -1990,    3449,78433,    6572,-9903
1157,JAPANESE YEN - CHICAGO MERCANTILE EXCHANGE,2002-11-26,11744,16208,   -1123,     450,71861,   -3231,-4464
1158,JAPANESE YEN - CHICAGO MERCANTILE EXCHANGE,2002-11-19,12867,15758,   -1197,    1267,75092,   -2330,-2891
1159,JAPANESE YEN - CHICAGO MERCANTILE EXCHANGE,2002-11-12,14064,14491,    1652,   -2617,77422,    2164,-427
1160,JAPANESE YEN - CHICAGO MERCANTILE EXCHANGE,2002-11-05,12412,17108,    -773,   -4341,75258,   -4211,-4696
1161,JAPANESE YEN - CHICAGO MERCANTILE EXCHANGE,2002-10-29,13185,21449,    4417,   -2253,79469,   -5874,-8264
1162,JAPANESE YEN - CHICAGO MERCANTILE EXCHANGE,2002-10-22,8768,23702,     162,    2266,85343,    5056,-14934
1163,JAPANESE YEN - CHICAGO MERCANTILE EXCHANGE,2002-10-15,8606,21436,   -1235,   -1646,80287,   -2208,-12830
1164,JAPANESE YEN - CHICAGO MERCANTILE EXCHANGE,2002-10-08,9841,23082,    7255,    5183,82495,   11440,-13241
1165,JAPANESE YEN - CHICAGO MERCANTILE EXCHANGE,2002-10-01,2586,17899,     760,   -2007,71055,     586,-15313
1166,JAPANESE YEN - CHICAGO MERCANTILE EXCHANGE,2002-09-24,1826,19906,    -170,    1536,70469,    2174,-18080
1167,JAPANESE YEN - CHICAGO MERCANTILE EXCHANGE,2002-09-17,1996,18370,  -13001,    6593,68295,  -33778,-16374
1168,JAPANESE YEN - CHICAGO MERCANTILE EXCHANGE,2002-09-10,14997,11777,   -2856,     565,102073,   25027,3220
1169,JAPANESE YEN - CHICAGO MERCANTILE EXCHANGE,2002-09-03,17853,11212,    2846,     556,77046,    4400,6641
1170,JAPANESE YEN - CHICAGO MERCANTILE EXCHANGE,2002-08-27,15007,10656,    2511,    1572,72646,    1672,4351
1171,JAPANESE YEN - CHICAGO MERCANTILE EXCHANGE,2002-08-20,12496,9084,    -741,    -489,70974,      26,3412
1172,JAPANESE YEN - CHICAGO MERCANTILE EXCHANGE,2002-08-13,13237,9573,     897,   -2061,70948,    -306,3664
1173,JAPANESE YEN - CHICAGO MERCANTILE EXCHANGE,2002-08-06,12340,11634,   -2112,    1034,71254,   -2693,706
1174,JAPANESE YEN - CHICAGO MERCANTILE EXCHANGE,2002-07-30,14452,10600,   -5810,     201,73947,   -2531,3852
1175,JAPANESE YEN - CHICAGO MERCANTILE EXCHANGE,2002-07-23,20262,10399,   -1399,     -41,76478,   -2072,9863
1176,JAPANESE YEN - CHICAGO MERCANTILE EXCHANGE,2002-07-16,21661,10440,     862,    -159,78550,     481,11221
1177,JAPANESE YEN - CHICAGO MERCANTILE EXCHANGE,2002-07-09,20799,10599,    1013,    -141,78069,    3596,10200
1178,JAPANESE YEN - CHICAGO MERCANTILE EXCHANGE,2002-07-02,19786,10740,   -2206,    -643,74473,   -1014,9046
1179,JAPANESE YEN - CHICAGO MERCANTILE EXCHANGE,2002-06-25,21992,11383,    2568,    1428,75487,    6853,10609
1180,JAPANESE YEN - CHICAGO MERCANTILE EXCHANGE,2002-06-18,19424,9955,    1650,   -1744,68634,  -36489,9469
1181,JAPANESE YEN - CHICAGO MERCANTILE EXCHANGE,2002-06-11,17774,11699,      59,    2359,105123,    7498,6075
1182,JAPANESE YEN - CHICAGO MERCANTILE EXCHANGE,2002-06-04,17715,9340,   -2766,    1033,97625,    2677,8375
1183,JAPANESE YEN - CHICAGO MERCANTILE EXCHANGE,2002-05-28,20481,8307,   -1319,     369,94948,    -957,12174
1184,JAPANESE YEN - CHICAGO MERCANTILE EXCHANGE,2002-05-21,21800,7938,    7217,   -3831,95905,   12583,13862
1185,JAPANESE YEN - CHICAGO MERCANTILE EXCHANGE,2002-05-14,14583,11769,   -2289,    1411,83322,    -709,2814
1186,JAPANESE YEN - CHICAGO MERCANTILE EXCHANGE,2002-05-07,16872,10358,     115,    -745,84031,    1410,6514
1187,JAPANESE YEN - CHICAGO MERCANTILE EXCHANGE,2002-04-30,16757,11103,    4110,   -2270,82621,   14667,5654
1188,JAPANESE YEN - CHICAGO MERCANTILE EXCHANGE,2002-04-23,12647,13373,    4003,   -4022,67954,   -3932,-726
1189,JAPANESE YEN - CHICAGO MERCANTILE EXCHANGE,2002-04-16,8644,17395,    1156,    -934,71886,    1973,-8751
1190,JAPANESE YEN - CHICAGO MERCANTILE EXCHANGE,2002-04-09,7488,18329,   -6686,   -5102,69913,   -8291,-10841
1191,JAPANESE YEN - CHICAGO MERCANTILE EXCHANGE,2002-04-02,14174,23431,    1233,    6130,78204,    5821,-9257
1192,JAPANESE YEN - CHICAGO MERCANTILE EXCHANGE,2002-03-26,12941,17301,    -871,    2362,72383,    1309,-4360
1193,JAPANESE YEN - CHICAGO MERCANTILE EXCHANGE,2002-03-19,13812,14939,   -6698,    1327,71074,  -39774,-1127
1194,JAPANESE YEN - CHICAGO MERCANTILE EXCHANGE,2002-03-12,20510,13612,    6793,  -13751,110848,    5872,6898
1195,JAPANESE YEN - CHICAGO MERCANTILE EXCHANGE,2002-03-05,13717,27363,   -9413,  -15579,104976,  -22716,-13646
1196,JAPANESE YEN - CHICAGO MERCANTILE EXCHANGE,2002-02-26,23130,42942,    -114,    7366,127692,    5572,-19812
1197,JAPANESE YEN - CHICAGO MERCANTILE EXCHANGE,2002-02-19,23244,35576,     248,    4799,122120,    6804,-12332
1198,JAPANESE YEN - CHICAGO MERCANTILE EXCHANGE,2002-02-12,22996,30777,   -8596,   -4831,115316,  -13955,-7781
1199,JAPANESE YEN - CHICAGO MERCANTILE EXCHANGE,2002-02-05,31592,35608,    -132,   -2459,129271,    2287,-4016
1200,JAPANESE YEN - CHICAGO MERCANTILE EXCHANGE,2002-01-29,31724,38067,    4388,   -3670,126984,   -3474,-6343
1201,JAPANESE YEN - CHICAGO MERCANTILE EXCHANGE,2002-01-22,27336,41737,   -9207,    2591,130458,   -2717,-14401
1202,JAPANESE YEN - CHICAGO MERCANTILE EXCHANGE,2002-01-15,36543,39146,   -1900,   -2827,133175,   -2165,-2603
1203,JAPANESE YEN - CHICAGO MERCANTILE EXCHANGE,2002-01-08,38443,41973,   -1132,    3264,135340,    4572,-3530
1204,JAPANESE YEN - CHICAGO MERCANTILE EXCHANGE,2001-12-28,39575,38709,    2044,   -3143,130768,     904,866
1205,JAPANESE YEN - CHICAGO MERCANTILE EXCHANGE,2001-12-21,37531,41852,     511,    2897,129864,    3016,-4321
1206,JAPANESE YEN - CHICAGO MERCANTILE EXCHANGE,2001-12-18,37020,38955,     222,   -2101,126848,  -26492,-1935
1207,JAPANESE YEN - CHICAGO MERCANTILE EXCHANGE,2001-12-11,36798,41056,    7006,    2846,153340,   33392,-4258
1208,JAPANESE YEN - CHICAGO MERCANTILE EXCHANGE,2001-12-04,29792,38210,   11145,   -2067,119948,   10778,-8418
1209,JAPANESE YEN - CHICAGO MERCANTILE EXCHANGE,2001-11-27,18647,40277,    5156,    7900,109170,    6679,-21630
1210,JAPANESE YEN - CHICAGO MERCANTILE EXCHANGE,2001-11-20,13491,32377,   -5712,    8943,102491,    9672,-18886
1211,JAPANESE YEN - CHICAGO MERCANTILE EXCHANGE,2001-11-13,19203,23434,    4824,   -4859,92819,    1486,-4231
1212,JAPANESE YEN - CHICAGO MERCANTILE EXCHANGE,2001-11-06,14379,28293,   10562,   -2869,91333,    9526,-13914
1213,JAPANESE YEN - CHICAGO MERCANTILE EXCHANGE,2001-10-30,3817,31162,     229,    5790,81807,    6164,-27345
1214,JAPANESE YEN - CHICAGO MERCANTILE EXCHANGE,2001-10-23,3588,25372,  -11821,    8849,75643,     994,-21784
1215,JAPANESE YEN - CHICAGO MERCANTILE EXCHANGE,2001-10-16,15409,16523,   -5574,    5808,74649,    3044,-1114
1216,JAPANESE YEN - CHICAGO MERCANTILE EXCHANGE,2001-10-09,20983,10715,   -1455,    1786,71605,   -3569,10268
1217,JAPANESE YEN - CHICAGO MERCANTILE EXCHANGE,2001-10-02,22438,8929,  -17471,    -615,75174,  -14995,13509
1218,JAPANESE YEN - CHICAGO MERCANTILE EXCHANGE,2001-09-25,39909,9544,    2122,     196,90169,    3491,30365
1219,JAPANESE YEN - CHICAGO MERCANTILE EXCHANGE,2001-09-18,37787,9348,    5074,     128,86678,  -25444,28439
1220,JAPANESE YEN - CHICAGO MERCANTILE EXCHANGE,2001-09-10,32713,9220,   -8049,     969,112122,   -3761,23493
1221,JAPANESE YEN - CHICAGO MERCANTILE EXCHANGE,2001-09-04,40762,8251,     705,   -1626,115883,    3909,32511
1222,JAPANESE YEN - CHICAGO MERCANTILE EXCHANGE,2001-08-28,40057,9877,    -352,      79,111974,    2188,30180
1223,JAPANESE YEN - CHICAGO MERCANTILE EXCHANGE,2001-08-21,40409,9798,   13789,   -5264,109786,    7931,30611
1224,JAPANESE YEN - CHICAGO MERCANTILE EXCHANGE,2001-08-14,26620,15062,    -183,  -10313,101855,   -3189,11558
1225,JAPANESE YEN - CHICAGO MERCANTILE EXCHANGE,2001-08-07,26803,25375,     339,   -5524,105044,    -901,1428
1226,JAPANESE YEN - CHICAGO MERCANTILE EXCHANGE,2001-07-31,26464,30899,     450,    3656,105945,    5705,-4435
1227,JAPANESE YEN - CHICAGO MERCANTILE EXCHANGE,2001-07-24,26014,27243,    -971,   -9696,100240,   -2305,-1229
1228,JAPANESE YEN - CHICAGO MERCANTILE EXCHANGE,2001-07-17,26985,36939,    9965,   -4171,102545,    7102,-9954
1229,JAPANESE YEN - CHICAGO MERCANTILE EXCHANGE,2001-07-10,17020,41110,   14726,    6436,95443,   23434,-24090
1230,JAPANESE YEN - CHICAGO MERCANTILE EXCHANGE,2001-07-03,2294,34674,    -414,    7380,72009,    9565,-32380
1231,JAPANESE YEN - CHICAGO MERCANTILE EXCHANGE,2001-06-26,2708,27294,   -1995,    6725,62444,    6181,-24586
1232,JAPANESE YEN - CHICAGO MERCANTILE EXCHANGE,2001-06-19,4703,20569,  -11804,    6777,56263,  -41091,-15866
1233,JAPANESE YEN - CHICAGO MERCANTILE EXCHANGE,2001-06-12,16507,13792,     137,    2685,97354,    3716,2715
1234,JAPANESE YEN - CHICAGO MERCANTILE EXCHANGE,2001-06-05,16370,11107,    9709,   -5718,93638,    6358,5263
1235,JAPANESE YEN - CHICAGO MERCANTILE EXCHANGE,2001-05-29,6661,16825,    4130,  -12754,87280,  -10456,-10164
1236,JAPANESE YEN - CHICAGO MERCANTILE EXCHANGE,2001-05-22,2531,29579,  -23898,     835,97736,    5408,-27048
1237,JAPANESE YEN - CHICAGO MERCANTILE EXCHANGE,2001-05-15,26429,28744,    -267,    -871,92328,    2076,-2315
1238,JAPANESE YEN - CHICAGO MERCANTILE EXCHANGE,2001-05-08,26696,29615,    5593,    2799,90252,    3796,-2919
1239,JAPANESE YEN - CHICAGO MERCANTILE EXCHANGE,2001-05-01,21103,26816,   17328,    -419,86456,   -1414,-5713
1240,JAPANESE YEN - CHICAGO MERCANTILE EXCHANGE,2001-04-24,3775,27235,    1483,    -643,87870,   -2994,-23460
1241,JAPANESE YEN - CHICAGO MERCANTILE EXCHANGE,2001-04-17,2292,27878,  -31829,   -4322,90864,  -14651,-25586
1242,JAPANESE YEN - CHICAGO MERCANTILE EXCHANGE,2001-04-10,34121,32200,    -629,    -799,105515,   -1173,1921
1243,JAPANESE YEN - CHICAGO MERCANTILE EXCHANGE,2001-04-03,34750,32999,     798,    2534,106688,    6971,1751
1244,JAPANESE YEN - CHICAGO MERCANTILE EXCHANGE,2001-03-27,33952,30465,   -2723,   -6791,99717,   -3632,3487
1245,JAPANESE YEN - CHICAGO MERCANTILE EXCHANGE,2001-03-20,36675,37256,   13641,   -4085,103349,  -20622,-581
1246,JAPANESE YEN - CHICAGO MERCANTILE EXCHANGE,2001-03-13,23034,41341,   22112,    8912,123971,   25397,-18307
1247,JAPANESE YEN - CHICAGO MERCANTILE EXCHANGE,2001-03-06,922,32429,      73,    4043,98574,    9358,-31507
1248,JAPANESE YEN - CHICAGO MERCANTILE EXCHANGE,2001-02-27,849,28386,     167,     644,89216,    -457,-27537
1249,JAPANESE YEN - CHICAGO MERCANTILE EXCHANGE,2001-02-20,682,27742,    -802,   -1216,89673,   -1291,-27060
1250,JAPANESE YEN - CHICAGO MERCANTILE EXCHANGE,2001-02-13,1484,28958,    -345,    1093,90964,   -1668,-27474
1251,JAPANESE YEN - CHICAGO MERCANTILE EXCHANGE,2001-02-06,1829,27865,     223,    1059,92632,    5212,-26036
1252,JAPANESE YEN - CHICAGO MERCANTILE EXCHANGE,2001-01-30,1606,26806,   -3005,   -7017,87420,   -3948,-25200
1253,JAPANESE YEN - CHICAGO MERCANTILE EXCHANGE,2001-01-23,4611,33823,    2734,   -1924,91368,    1307,-29212
1254,JAPANESE YEN - CHICAGO MERCANTILE EXCHANGE,2001-01-16,1877,35747,     327,   -5941,90061,   -1030,-33870
1255,JAPANESE YEN - CHICAGO MERCANTILE EXCHANGE,2001-01-09,1550,41688,     -63,   -1344,91091,    -167,-40138
1256,JAPANESE YEN - CHICAGO MERCANTILE EXCHANGE,2001-01-02,1613,43032,     -21,   -1222,91258,     455,-41419
1257,JAPANESE YEN - CHICAGO MERCANTILE EXCHANGE,2000-12-26,1634,44254,     846,    5233,90803,    3240,-42620
1258,JAPANESE YEN - CHICAGO MERCANTILE EXCHANGE,2000-12-19,788,39021,     678,   -2785,87563,  -42484,-38233
1259,JAPANESE YEN - CHICAGO MERCANTILE EXCHANGE,2000-12-12,110,41806,    -743,    8504,130047,   47620,-41696
1260,JAPANESE YEN - CHICAGO MERCANTILE EXCHANGE,2000-12-05,853,33302,     -13,    -894,82427,    5002,-32449
1261,JAPANESE YEN - CHICAGO MERCANTILE EXCHANGE,2000-11-28,866,34196,    -120,   -1862,77425,     -74,-33330
1262,JAPANESE YEN - CHICAGO MERCANTILE EXCHANGE,2000-11-21,986,36058,    -329,   12173,77499,   17992,-35072
1263,JAPANESE YEN - CHICAGO MERCANTILE EXCHANGE,2000-11-14,1315,23885,     700,    -607,59507,     430,-22570
1264,JAPANESE YEN - CHICAGO MERCANTILE EXCHANGE,2000-11-07,615,24492,    -532,   -3734,59077,   -9821,-23877
1265,JAPANESE YEN - CHICAGO MERCANTILE EXCHANGE,2000-10-31,1147,28226,     166,    -566,68898,    3550,-27079
1266,JAPANESE YEN - CHICAGO MERCANTILE EXCHANGE,2000-10-24,981,28792,      16,   -1500,65348,      50,-27811
1267,JAPANESE YEN - CHICAGO MERCANTILE EXCHANGE,2000-10-17,965,30292,     -12,    -773,65298,    -807,-29327
1268,JAPANESE YEN - CHICAGO MERCANTILE EXCHANGE,2000-10-10,977,31065,   -1267,   15054,66105,   11606,-30088
1269,JAPANESE YEN - CHICAGO MERCANTILE EXCHANGE,2000-10-03,2244,16011,   -3062,    6479,54499,   10526,-13767
1270,JAPANESE YEN - CHICAGO MERCANTILE EXCHANGE,2000-09-26,5306,9532,    1572,    1966,43973,    5542,-4226
1271,JAPANESE YEN - CHICAGO MERCANTILE EXCHANGE,2000-09-19,3734,7566,  -10682,    -516,38431,  -53959,-3832
1272,JAPANESE YEN - CHICAGO MERCANTILE EXCHANGE,2000-09-12,14416,8082,    8940,   -4496,92390,   20570,6334
1273,JAPANESE YEN - CHICAGO MERCANTILE EXCHANGE,2000-09-05,5476,12578,   -1467,   -7340,71820,   -6103,-7102
1274,JAPANESE YEN - CHICAGO MERCANTILE EXCHANGE,2000-08-29,6943,19918,    6803,   -8701,77923,   -2708,-12975
1275,JAPANESE YEN - INTERNATIONAL MONETARY MARKET,2000-08-22,140,28619,     140,    -185,80631,   -1457,-28479
1276,JAPANESE YEN - INTERNATIONAL MONETARY MARKET,2000-08-15,0,28804,    -471,    1581,82088,    5216,-28804
1277,JAPANESE YEN - INTERNATIONAL MONETARY MARKET,2000-08-08,471,27223,   -1032,     721,76872,    -990,-26752
1278,JAPANESE YEN - INTERNATIONAL MONETARY MARKET,2000-08-01,1503,26502,    1068,    3838,77862,    8146,-24999
1279,JAPANESE YEN - INTERNATIONAL MONETARY MARKET,2000-07-25,435,22664,    -206,    7537,69716,    7972,-22229
1280,JAPANESE YEN - INTERNATIONAL MONETARY MARKET,2000-07-18,641,15127,    -322,    6375,61744,    9345,-14486
1281,JAPANESE YEN - INTERNATIONAL MONETARY MARKET,2000-07-11,963,8752,   -2860,   -1141,52399,    3648,-7789
1282,JAPANESE YEN - INTERNATIONAL MONETARY MARKET,2000-07-05,3823,9893,   -4428,    3283,48751,    1965,-6070
1283,JAPANESE YEN - INTERNATIONAL MONETARY MARKET,2000-06-27,8251,6610,    7433,   -1980,46786,    6719,1641
1284,JAPANESE YEN - INTERNATIONAL MONETARY MARKET,2000-06-20,818,8590,    -801,   -2967,40067,  -39565,-7772
1285,JAPANESE YEN - INTERNATIONAL MONETARY MARKET,2000-06-13,1619,11557,     286,   -4586,79632,   -2413,-9938
1286,JAPANESE YEN - INTERNATIONAL MONETARY MARKET,2000-06-06,1333,16143,     570,    2915,82045,    3415,-14810
1287,JAPANESE YEN - INTERNATIONAL MONETARY MARKET,2000-05-30,763,13228,      11,    -703,78630,    -924,-12465
1288,JAPANESE YEN - INTERNATIONAL MONETARY MARKET,2000-05-23,752,13931,      -9,   -4212,79554,   -3348,-13179
1289,JAPANESE YEN - INTERNATIONAL MONETARY MARKET,2000-05-16,761,18143,    -762,   -3056,82902,    2187,-17382
1290,JAPANESE YEN - INTERNATIONAL MONETARY MARKET,2000-05-09,1523,21199,   -2587,    4239,80715,     556,-19676
1291,JAPANESE YEN - INTERNATIONAL MONETARY MARKET,2000-05-02,4110,16960,   -8144,    8279,80159,    5120,-12850
1292,JAPANESE YEN - INTERNATIONAL MONETARY MARKET,2000-04-25,12254,8681,   -1170,     871,75039,     -36,3573
1293,JAPANESE YEN - INTERNATIONAL MONETARY MARKET,2000-04-18,13424,7810,    1382,    -306,75075,    3008,5614
1294,JAPANESE YEN - INTERNATIONAL MONETARY MARKET,2000-04-11,12042,8116,   -3277,     112,72067,   -4625,3926
1295,JAPANESE YEN - INTERNATIONAL MONETARY MARKET,2000-04-04,15319,8004,    9258,  -20146,76692,    7310,7315
1296,JAPANESE YEN - INTERNATIONAL MONETARY MARKET,2000-03-28,6061,28150,    1617,    -265,69382,    1051,-22089
1297,JAPANESE YEN - INTERNATIONAL MONETARY MARKET,2000-03-21,4444,28415,   -5862,    -291,68331,   -2902,-23971
1298,JAPANESE YEN - INTERNATIONAL MONETARY MARKET,2000-03-14,10306,28706,   -8216,   -3504,71233,  -56401,-18400
1299,JAPANESE YEN - INTERNATIONAL MONETARY MARKET,2000-03-07,18522,32210,    2543,  -29163,127634,     639,-13688
1300,JAPANESE YEN - INTERNATIONAL MONETARY MARKET,2000-02-29,15979,61373,     387,   -4575,126995,   -3319,-45394
1301,JAPANESE YEN - INTERNATIONAL MONETARY MARKET,2000-02-22,15592,65948,    -253,    2278,130314,    3020,-50356
1302,JAPANESE YEN - INTERNATIONAL MONETARY MARKET,2000-02-15,15845,63670,     393,    4940,127294,    4901,-47825
1303,JAPANESE YEN - INTERNATIONAL MONETARY MARKET,2000-02-08,15452,58730,     532,    6693,122393,    7785,-43278
1304,JAPANESE YEN - INTERNATIONAL MONETARY MARKET,2000-02-01,14920,52037,     525,   13864,114608,   12511,-37117
1305,JAPANESE YEN - INTERNATIONAL MONETARY MARKET,2000-01-25,14395,38173,    -157,   -1210,102097,    3149,-23778
1306,JAPANESE YEN - INTERNATIONAL MONETARY MARKET,2000-01-18,14552,39383,     651,    2729,98948,    2080,-24831
1307,JAPANESE YEN - INTERNATIONAL MONETARY MARKET,2000-01-11,13901,36654,   -9696,   28532,96868,   22496,-22753
1308,JAPANESE YEN - INTERNATIONAL MONETARY MARKET,2000-01-04,23597,8122,   -2853,   -1332,74372,     646,15475
1309,JAPANESE YEN - INTERNATIONAL MONETARY MARKET,1999-12-28,26450,9454,    2963,    -283,73726,     198,16996
1310,JAPANESE YEN - INTERNATIONAL MONETARY MARKET,1999-12-21,23487,9737,    4475,     391,73528,    3151,13750
1311,JAPANESE YEN - INTERNATIONAL MONETARY MARKET,1999-12-14,19012,9346,  -22675,   -2016,70377,  -36989,9666
1312,JAPANESE YEN - INTERNATIONAL MONETARY MARKET,1999-12-07,41687,11362,   -7751,     -96,107366,    7650,30325
1313,JAPANESE YEN - INTERNATIONAL MONETARY MARKET,1999-11-30,49438,11458,   11390,     121,99716,    9625,37980
1314,JAPANESE YEN - INTERNATIONAL MONETARY MARKET,1999-11-23,38048,11337,    6399,   -5314,90091,    5152,26711
1315,JAPANESE YEN - INTERNATIONAL MONETARY MARKET,1999-11-16,31649,16651,    -359,    3795,84939,    -516,14998
1316,JAPANESE YEN - INTERNATIONAL MONETARY MARKET,1999-11-09,32008,12856,   -6597,    2058,85455,   -2334,19152
1317,JAPANESE YEN - INTERNATIONAL MONETARY MARKET,1999-11-02,38605,10798,    -456,    -550,87789,    3445,27807
1318,JAPANESE YEN - INTERNATIONAL MONETARY MARKET,1999-10-26,39061,11348,    -201,   -4536,84344,     343,27713
1319,JAPANESE YEN - INTERNATIONAL MONETARY MARKET,1999-10-19,39262,15884,    1875,    5667,84001,    3231,23378
1320,JAPANESE YEN - INTERNATIONAL MONETARY MARKET,1999-10-12,37387,10217,     642,      66,80770,     857,27170
1321,JAPANESE YEN - INTERNATIONAL MONETARY MARKET,1999-10-05,36745,10151,   -3625,    1066,79913,   -1218,26594
1322,JAPANESE YEN - INTERNATIONAL MONETARY MARKET,1999-09-28,40370,9085,   -5462,     152,81131,   -5811,31285
1323,JAPANESE YEN - INTERNATIONAL MONETARY MARKET,1999-09-21,45832,8933,   -8213,   -3988,86942,   -6277,36899
1324,JAPANESE YEN - INTERNATIONAL MONETARY MARKET,1999-09-14,54045,12921,   -4140,    -631,93219,  -61667,41124
1325,JAPANESE YEN - INTERNATIONAL MONETARY MARKET,1999-09-07,58185,13552,   -9044,     225,154886,    8016,44633
1326,JAPANESE YEN - INTERNATIONAL MONETARY MARKET,1999-08-31,67229,13327,    8051,   -1420,146870,    7214,53902
1327,JAPANESE YEN - INTERNATIONAL MONETARY MARKET,1999-08-24,59178,14747,    3177,      58,139656,    3599,44431
1328,JAPANESE YEN - INTERNATIONAL MONETARY MARKET,1999-08-17,56001,14689,    -617,   -1852,136057,    3379,41312
1329,JAPANESE YEN - INTERNATIONAL MONETARY MARKET,1999-08-10,56618,16541,      53,    1845,132678,    1108,40077
1330,JAPANESE YEN - INTERNATIONAL MONETARY MARKET,1999-08-03,56565,14696,    6994,  -10114,131570,     897,41869
1331,JAPANESE YEN - INTERNATIONAL MONETARY MARKET,1999-07-27,49571,24810,   17815,   -9656,130673,   14974,24761
1332,JAPANESE YEN - INTERNATIONAL MONETARY MARKET,1999-07-20,31756,34466,   25990,  -24498,115699,    1991,-2710
1333,JAPANESE YEN - INTERNATIONAL MONETARY MARKET,1999-07-13,5766,58964,    1705,    4927,113708,    2074,-53198
1334,JAPANESE YEN - INTERNATIONAL MONETARY MARKET,1999-07-06,4061,54037,     500,    1409,111634,    3400,-49976
1335,JAPANESE YEN - INTERNATIONAL MONETARY MARKET,1999-06-29,3561,52628,    1383,    -393,108234,    4182,-49067
1336,JAPANESE YEN - INTERNATIONAL MONETARY MARKET,1999-06-22,2178,53021,    -279,   10503,104052,    7696,-50843
1337,JAPANESE YEN - INTERNATIONAL MONETARY MARKET,1999-06-15,2457,42518,   -2344,  -11285,96356,  -49986,-40061
1338,JAPANESE YEN - INTERNATIONAL MONETARY MARKET,1999-06-08,4801,53803,     933,    4012,146342,   28228,-49002
1339,JAPANESE YEN - INTERNATIONAL MONETARY MARKET,1999-06-01,3868,49791,    2041,  -14220,118114,  -13640,-45923
1340,JAPANESE YEN - INTERNATIONAL MONETARY MARKET,1999-05-25,1827,64011,   -1191,   -5704,131754,   -4330,-62184
1341,JAPANESE YEN - INTERNATIONAL MONETARY MARKET,1999-05-18,3018,69715,     612,   23244,136084,   33937,-66697
1342,JAPANESE YEN - INTERNATIONAL MONETARY MARKET,1999-05-11,2406,46471,   -2964,    2663,102147,    2557,-44065
1343,JAPANESE YEN - INTERNATIONAL MONETARY MARKET,1999-05-04,5370,43808,    2464,    5592,99590,    5118,-38438
1344,JAPANESE YEN - INTERNATIONAL MONETARY MARKET,1999-04-27,2906,38216,    -306,    9327,94472,    8806,-35310
1345,JAPANESE YEN - INTERNATIONAL MONETARY MARKET,1999-04-20,3212,28889,    1123,   -9579,85666,    1758,-25677
1346,JAPANESE YEN - INTERNATIONAL MONETARY MARKET,1999-04-13,2089,38468,     351,    1033,83908,   -1528,-36379
1347,JAPANESE YEN - INTERNATIONAL MONETARY MARKET,1999-04-06,1738,37435,    -788,   -3554,85436,     156,-35697
1348,JAPANESE YEN - INTERNATIONAL MONETARY MARKET,1999-03-30,2526,40989,     398,    7131,85280,   10646,-38463
1349,JAPANESE YEN - INTERNATIONAL MONETARY MARKET,1999-03-23,2128,33858,     250,     188,74634,     205,-31730
1350,JAPANESE YEN - INTERNATIONAL MONETARY MARKET,1999-03-16,1878,33670,     573,  -11893,74429,  -50176,-31792
1351,JAPANESE YEN - INTERNATIONAL MONETARY MARKET,1999-03-09,1305,45563,   -1231,    6816,124605,   27021,-44258
1352,JAPANESE YEN - INTERNATIONAL MONETARY MARKET,1999-03-02,2536,38747,    1052,    2973,97584,    8499,-36211
1353,JAPANESE YEN - INTERNATIONAL MONETARY MARKET,1999-02-23,1484,35774,   -5678,   17496,89085,   16841,-34290
1354,JAPANESE YEN - INTERNATIONAL MONETARY MARKET,1999-02-16,7162,18278,  -11079,    6226,72244,   -4174,-11116
1355,JAPANESE YEN - INTERNATIONAL MONETARY MARKET,1999-02-09,18241,12052,    -956,   -1041,76418,   -1899,6189
1356,JAPANESE YEN - INTERNATIONAL MONETARY MARKET,1999-02-02,19197,13093,   -3955,   -1491,78317,     254,6104
1357,JAPANESE YEN - INTERNATIONAL MONETARY MARKET,1999-01-26,23152,14584,    -427,   -4004,78063,    -558,8568
1358,JAPANESE YEN - INTERNATIONAL MONETARY MARKET,1999-01-19,23579,18588,   -4657,    7278,78621,   -1853,4991
1359,JAPANESE YEN - INTERNATIONAL MONETARY MARKET,1999-01-12,28236,11310,   -4649,     445,80474,    1565,16926
1360,JAPANESE YEN - INTERNATIONAL MONETARY MARKET,1999-01-05,32885,10865,   11922,    -221,78909,   12720,22020
1361,JAPANESE YEN - INTERNATIONAL MONETARY MARKET,1998-12-29,20963,11086,    1337,    -630,66189,     726,9877
1362,JAPANESE YEN - INTERNATIONAL MONETARY MARKET,1998-12-22,19626,11716,     184,     440,65463,     -80,7910
1363,JAPANESE YEN - INTERNATIONAL MONETARY MARKET,1998-12-15,19442,11276,    4849,   -1022,65543,  -23884,8166
1364,JAPANESE YEN - INTERNATIONAL MONETARY MARKET,1998-12-08,14593,12298,    2292,   -2239,89427,    5370,2295
1365,JAPANESE YEN - INTERNATIONAL MONETARY MARKET,1998-12-01,12301,14537,   -4214,   -1049,84057,   -1126,-2236
1366,JAPANESE YEN - INTERNATIONAL MONETARY MARKET,1998-11-24,16515,15586,   -1733,    -102,85183,   -1457,929
1367,JAPANESE YEN - INTERNATIONAL MONETARY MARKET,1998-11-17,18248,15688,    1663,     176,86640,   -8687,2560
1368,JAPANESE YEN - INTERNATIONAL MONETARY MARKET,1998-11-10,16585,15512,   -8508,    -876,95327,    5767,1073
1369,JAPANESE YEN - INTERNATIONAL MONETARY MARKET,1998-11-03,25093,16388,    2364,   -1851,89560,    1769,8705
1370,JAPANESE YEN - INTERNATIONAL MONETARY MARKET,1998-10-27,22729,18239,   -2514,    1216,87791,   -2000,4490
1371,JAPANESE YEN - INTERNATIONAL MONETARY MARKET,1998-10-20,25243,17023,    2354,     383,89791,    1675,8220
1372,JAPANESE YEN - INTERNATIONAL MONETARY MARKET,1998-10-13,22889,16640,   -5273,   -3696,88116,   -1655,6249
1373,JAPANESE YEN - INTERNATIONAL MONETARY MARKET,1998-10-06,28162,20336,    8855,    1891,89771,    5412,7826
1374,JAPANESE YEN - INTERNATIONAL MONETARY MARKET,1998-09-29,19307,18445,     604,    1805,84359,    6465,862
1375,JAPANESE YEN - INTERNATIONAL MONETARY MARKET,1998-09-22,18703,16640,   -3005,     755,77894,   -1899,2063
1376,JAPANESE YEN - INTERNATIONAL MONETARY MARKET,1998-09-15,21708,15885,   -3725,   -1118,79793,  -58697,5823
1377,JAPANESE YEN - INTERNATIONAL MONETARY MARKET,1998-09-08,25433,17003,   16355,   -7392,138490,    2291,8430
1378,JAPANESE YEN - INTERNATIONAL MONETARY MARKET,1998-09-01,9078,24395,    4392,  -21973,136199,   -7970,-15317
1379,JAPANESE YEN - INTERNATIONAL MONETARY MARKET,1998-08-25,4686,46368,   -4326,   -6069,144169,   -3898,-41682
1380,JAPANESE YEN - INTERNATIONAL MONETARY MARKET,1998-08-18,9012,52437,    5139,   -6134,148067,   -2737,-43425
1381,JAPANESE YEN - INTERNATIONAL MONETARY MARKET,1998-08-11,3873,58571,   -3690,    5300,150804,    8360,-54698
1382,JAPANESE YEN - INTERNATIONAL MONETARY MARKET,1998-08-04,7563,53271,    4433,   12217,142444,   26260,-45708
1383,JAPANESE YEN - INTERNATIONAL MONETARY MARKET,1998-07-28,3130,41054,   -2570,    3152,116184,    5861,-37924
1384,JAPANESE YEN - INTERNATIONAL MONETARY MARKET,1998-07-21,5700,37902,    3160,    2255,110323,    3166,-32202
1385,JAPANESE YEN - INTERNATIONAL MONETARY MARKET,1998-07-14,2540,35647,   -2841,     221,107157,   -4335,-33107
1386,JAPANESE YEN - INTERNATIONAL MONETARY MARKET,1998-07-07,5381,35426,     777,    1849,111492,    2711,-30045
1387,JAPANESE YEN - INTERNATIONAL MONETARY MARKET,1998-06-30,4604,33577,     779,     881,108781,   -4207,-28973
1388,JAPANESE YEN - INTERNATIONAL MONETARY MARKET,1998-06-23,3825,32696,   -7703,  -25579,112988,   -5914,-28871
1389,JAPANESE YEN - INTERNATIONAL MONETARY MARKET,1998-06-16,11528,58275,    3004,  -11044,118902,  -36069,-46747
1390,JAPANESE YEN - INTERNATIONAL MONETARY MARKET,1998-06-09,8524,69319,     402,    2990,154971,   23421,-60795
1391,JAPANESE YEN - INTERNATIONAL MONETARY MARKET,1998-06-02,8122,66329,    3511,   -1760,131550,    6960,-58207
1392,JAPANESE YEN - INTERNATIONAL MONETARY MARKET,1998-05-26,4611,68089,     893,   10945,124590,    3698,-63478
1393,JAPANESE YEN - INTERNATIONAL MONETARY MARKET,1998-05-19,3718,57144,     446,   21950,120892,   28072,-53426
1394,JAPANESE YEN - INTERNATIONAL MONETARY MARKET,1998-05-12,3272,35194,   -2792,    2389,92820,      17,-31922
1395,JAPANESE YEN - INTERNATIONAL MONETARY MARKET,1998-05-05,6064,32805,    4008,     324,92803,    4480,-26741
1396,JAPANESE YEN - INTERNATIONAL MONETARY MARKET,1998-04-28,2056,32481,   -1816,  -10714,88323,   -5036,-30425
1397,JAPANESE YEN - INTERNATIONAL MONETARY MARKET,1998-04-21,3872,43195,      46,    2105,93359,    3601,-39323
1398,JAPANESE YEN - INTERNATIONAL MONETARY MARKET,1998-04-14,3826,41090,    -229,  -18890,89758,  -28914,-37264
1399,JAPANESE YEN - INTERNATIONAL MONETARY MARKET,1998-04-07,4055,59980,     -35,   13092,118672,   19027,-55925
1400,JAPANESE YEN - INTERNATIONAL MONETARY MARKET,1998-03-31,4090,46888,    -249,   10444,99645,   17657,-42798
1401,JAPANESE YEN - INTERNATIONAL MONETARY MARKET,1998-03-24,4339,36444,    -598,   10391,81988,   13066,-32105
1402,JAPANESE YEN - INTERNATIONAL MONETARY MARKET,1998-03-17,4937,26053,     549,    7548,68922,  -38214,-21116
1403,JAPANESE YEN - INTERNATIONAL MONETARY MARKET,1998-03-10,4388,18505,   -2702,    2476,107136,    9968,-14117
1404,JAPANESE YEN - INTERNATIONAL MONETARY MARKET,1998-03-03,7090,16029,   -1335,   -1644,97168,   -1037,-8939
1405,JAPANESE YEN - INTERNATIONAL MONETARY MARKET,1998-02-24,8425,17673,    -905,    1720,98205,   -6005,-9248
1406,JAPANESE YEN - INTERNATIONAL MONETARY MARKET,1998-02-17,9330,15953,   -9346,   -3600,104210,    -118,-6623
1407,JAPANESE YEN - INTERNATIONAL MONETARY MARKET,1998-02-10,18676,19553,   12120,  -11275,104328,    5727,-877
1408,JAPANESE YEN - INTERNATIONAL MONETARY MARKET,1998-02-03,6556,30828,     305,    1947,98601,    7232,-24272
1409,JAPANESE YEN - INTERNATIONAL MONETARY MARKET,1998-01-27,6251,28881,    2776,   -4855,91369,     330,-22630
1410,JAPANESE YEN - INTERNATIONAL MONETARY MARKET,1998-01-20,3475,33736,     590,   -6761,91039,   -6461,-30261
1411,JAPANESE YEN - INTERNATIONAL MONETARY MARKET,1998-01-13,2885,40497,    -844,   -5285,97500,   -2638,-37612
1412,JAPANESE YEN - INTERNATIONAL MONETARY MARKET,1998-01-06,3729,45782,     115,    8210,100138,   12838,-42053
1413,JAPANESE YEN - INTERNATIONAL MONETARY MARKET,1997-12-30,3614,37572,     110,   -1339,87300,   -1839,-33958
1414,JAPANESE YEN - INTERNATIONAL MONETARY MARKET,1997-12-23,3504,38911,    -823,   -8502,89139,  -10852,-35407
1415,JAPANESE YEN - INTERNATIONAL MONETARY MARKET,1997-12-19,3775,39933,    -552,   -7480,91440,   -8551,-36158
1416,JAPANESE YEN - INTERNATIONAL MONETARY MARKET,1997-12-16,4327,47413,   -2496,   -3010,99991,  -57459,-43086
1417,JAPANESE YEN - INTERNATIONAL MONETARY MARKET,1997-12-09,6823,50423,    3093,    3545,157450,   13984,-43600
1418,JAPANESE YEN - INTERNATIONAL MONETARY MARKET,1997-12-02,3730,46878,   -2428,     513,143466,    9854,-43148
1419,JAPANESE YEN - INTERNATIONAL MONETARY MARKET,1997-11-25,6158,46365,   -2757,     -72,133612,   -5041,-40207
1420,JAPANESE YEN - INTERNATIONAL MONETARY MARKET,1997-11-18,8915,46437,   -2437,     950,138653,    3704,-37522
1421,JAPANESE YEN - INTERNATIONAL MONETARY MARKET,1997-11-11,11352,45487,    1387,   14680,134949,   26143,-34135
1422,JAPANESE YEN - INTERNATIONAL MONETARY MARKET,1997-11-04,9965,30807,   -2710,    1877,108806,    3155,-20842
1423,JAPANESE YEN - INTERNATIONAL MONETARY MARKET,1997-10-28,12675,28930,   -2309,    3039,105651,   17668,-16255
1424,JAPANESE YEN - INTERNATIONAL MONETARY MARKET,1997-10-21,14984,25891,    6012,   -1850,87983,    3139,-10907
1425,JAPANESE YEN - INTERNATIONAL MONETARY MARKET,1997-10-14,8972,27741,    4599,   -9634,84844,   -3336,-18769
1426,JAPANESE YEN - INTERNATIONAL MONETARY MARKET,1997-10-07,4373,37375,    -472,    6397,88180,   10600,-33002
1427,JAPANESE YEN - INTERNATIONAL MONETARY MARKET,1997-09-30,4845,30978,    1252,    2230,77580,     740,-26133
1428,JAPANESE YEN - INTERNATIONAL MONETARY MARKET,1997-09-23,3593,28748,     723,    2657,76840,    5364,-25155
1429,JAPANESE YEN - INTERNATIONAL MONETARY MARKET,1997-09-16,2870,26091,   -2576,     242,71476,  -54345,-23221
1430,JAPANESE YEN - INTERNATIONAL MONETARY MARKET,1997-09-09,5446,25849,   -1096,  -10007,125821,   15668,-20403
1431,JAPANESE YEN - INTERNATIONAL MONETARY MARKET,1997-09-02,6542,35856,    2790,    9356,110153,   27222,-29314
1432,JAPANESE YEN - INTERNATIONAL MONETARY MARKET,1997-08-26,3752,26500,     970,   -3012,82931,    1662,-22748
1433,JAPANESE YEN - INTERNATIONAL MONETARY MARKET,1997-08-19,2782,29512,     306,    2711,81269,    7913,-26730
1434,JAPANESE YEN - INTERNATIONAL MONETARY MARKET,1997-08-12,2476,26801,    -188,   -5189,73356,   -8674,-24325
1435,JAPANESE YEN - INTERNATIONAL MONETARY MARKET,1997-08-05,2664,31990,   -2591,    4648,82030,    2497,-29326
1436,JAPANESE YEN - INTERNATIONAL MONETARY MARKET,1997-07-29,5255,27342,   -6124,   13346,79533,   19479,-22087
1437,JAPANESE YEN - INTERNATIONAL MONETARY MARKET,1997-07-22,11379,13996,   -1228,    -205,60054,    1593,-2617
1438,JAPANESE YEN - INTERNATIONAL MONETARY MARKET,1997-07-15,12607,14201,   -5911,    3874,58461,   -1729,-1594
1439,JAPANESE YEN - INTERNATIONAL MONETARY MARKET,1997-07-08,18518,10327,    4687,   -1036,60190,   10447,8191
1440,JAPANESE YEN - INTERNATIONAL MONETARY MARKET,1997-07-01,13831,11363,    1258,     -72,49743,   -3116,2468
1441,JAPANESE YEN - INTERNATIONAL MONETARY MARKET,1997-06-24,12573,11435,   -1378,    1945,52859,    1878,1138
1442,JAPANESE YEN - INTERNATIONAL MONETARY MARKET,1997-06-17,13951,9490,   -6109,    -265,50981,  -49997,4461
1443,JAPANESE YEN - INTERNATIONAL MONETARY MARKET,1997-06-10,20060,9755,   -1855,   -1321,100978,   16869,10305
1444,JAPANESE YEN - INTERNATIONAL MONETARY MARKET,1997-06-03,21915,11076,     694,    -198,84109,   -1005,10839
1445,JAPANESE YEN - INTERNATIONAL MONETARY MARKET,1997-05-27,21221,11274,   -3886,    -253,85114,   -9209,9947
1446,JAPANESE YEN - INTERNATIONAL MONETARY MARKET,1997-05-20,25107,11527,    5236,   -1373,94323,   12649,13580
1447,JAPANESE YEN - INTERNATIONAL MONETARY MARKET,1997-05-13,19871,12900,   16241,  -20535,81674,    -463,6971
1448,JAPANESE YEN - INTERNATIONAL MONETARY MARKET,1997-05-06,3630,33435,    1966,   -4092,82137,   -5116,-29805
1449,JAPANESE YEN - INTERNATIONAL MONETARY MARKET,1997-04-29,1664,37527,    -277,    1992,87253,    4717,-35863
1450,JAPANESE YEN - INTERNATIONAL MONETARY MARKET,1997-04-22,1941,35535,      66,      46,82536,   -1618,-33594
1451,JAPANESE YEN - INTERNATIONAL MONETARY MARKET,1997-04-15,1875,35489,    -740,    2234,84154,    4464,-33614
1452,JAPANESE YEN - INTERNATIONAL MONETARY MARKET,1997-04-08,2615,33255,     -84,    6823,79690,   11020,-30640
1453,JAPANESE YEN - INTERNATIONAL MONETARY MARKET,1997-04-01,2699,26432,      84,   -3210,68670,     808,-23733
1454,JAPANESE YEN - INTERNATIONAL MONETARY MARKET,1997-03-25,2615,29642,     569,    1926,67862,    5891,-27027
1455,JAPANESE YEN - INTERNATIONAL MONETARY MARKET,1997-03-18,2046,27716,    -340,    1103,61971,  -26192,-25670
1456,JAPANESE YEN - INTERNATIONAL MONETARY MARKET,1997-03-11,2386,26613,       6,    -852,88163,    9344,-24227
1457,JAPANESE YEN - INTERNATIONAL MONETARY MARKET,1997-03-04,2380,27465,    -496,   -2662,78819,   -1571,-25085
1458,JAPANESE YEN - INTERNATIONAL MONETARY MARKET,1997-02-25,2876,30127,    1797,   -4100,80390,   -1647,-27251
1459,JAPANESE YEN - INTERNATIONAL MONETARY MARKET,1997-02-18,1079,34227,     156,   -1405,82037,   -1813,-33148
1460,JAPANESE YEN - INTERNATIONAL MONETARY MARKET,1997-02-11,923,35632,   -2171,    -265,83850,    3976,-34709
1461,JAPANESE YEN - INTERNATIONAL MONETARY MARKET,1997-02-04,3094,35897,    1386,     963,79874,    4052,-32803
1462,JAPANESE YEN - INTERNATIONAL MONETARY MARKET,1997-01-28,1708,34934,     908,    1749,75822,     382,-33226
1463,JAPANESE YEN - INTERNATIONAL MONETARY MARKET,1997-01-21,800,33185,       9,    -213,75440,    2483,-32385
1464,JAPANESE YEN - INTERNATIONAL MONETARY MARKET,1997-01-14,791,33398,     554,    1857,72957,    1840,-32607
1465,JAPANESE YEN - INTERNATIONAL MONETARY MARKET,1997-01-07,237,31541,   -1546,    3283,71117,   11336,-31304
1466,JAPANESE YEN - INTERNATIONAL MONETARY MARKET,1996-12-31,1783,28258,     895,    2270,59781,    5135,-26475
1467,JAPANESE YEN - INTERNATIONAL MONETARY MARKET,1996-12-24,888,25988,    -414,     978,54646,     414,-25100
1468,JAPANESE YEN - INTERNATIONAL MONETARY MARKET,1996-12-17,1302,25010,      78,    1042,54232,  -22347,-23708
1469,JAPANESE YEN - INTERNATIONAL MONETARY MARKET,1996-12-10,1224,23968,     376,   -1470,76579,     350,-22744
1470,JAPANESE YEN - INTERNATIONAL MONETARY MARKET,1996-12-03,848,25438,   -1562,    4025,76229,    8817,-24590
1471,JAPANESE YEN - INTERNATIONAL MONETARY MARKET,1996-11-26,2410,21413,      79,     389,67412,   -3672,-19003
1472,JAPANESE YEN - INTERNATIONAL MONETARY MARKET,1996-11-19,2331,21024,    1282,   -1202,71084,    -389,-18693
1473,JAPANESE YEN - INTERNATIONAL MONETARY MARKET,1996-11-12,1049,22226,    -149,   -8494,71473,   -4265,-21177
1474,JAPANESE YEN - INTERNATIONAL MONETARY MARKET,1996-11-05,1198,30720,     -74,   -2103,75738,   -6527,-29522
1475,JAPANESE YEN - INTERNATIONAL MONETARY MARKET,1996-10-29,1272,32823,    1022,    2538,82265,    7792,-31551
1476,JAPANESE YEN - INTERNATIONAL MONETARY MARKET,1996-10-22,250,30285,    -715,   -1482,74473,   -1803,-30035
1477,JAPANESE YEN - INTERNATIONAL MONETARY MARKET,1996-10-15,965,31767,    -475,    -973,76276,    -502,-30802
1478,JAPANESE YEN - INTERNATIONAL MONETARY MARKET,1996-10-08,1440,32740,   -2216,   -3514,76778,   -1764,-31300
1479,JAPANESE YEN - INTERNATIONAL MONETARY MARKET,1996-10-01,3656,36254,     156,    2421,78542,    6239,-32598
1480,JAPANESE YEN - INTERNATIONAL MONETARY MARKET,1996-09-24,3500,33833,    1226,   -6125,72303,   -6652,-30333
1481,JAPANESE YEN - INTERNATIONAL MONETARY MARKET,1996-09-17,2274,39958,   -3049,    3112,78955,  -23634,-37684
1482,JAPANESE YEN - INTERNATIONAL MONETARY MARKET,1996-09-10,5323,36846,    -639,   12390,102589,   16303,-31523
1483,JAPANESE YEN - INTERNATIONAL MONETARY MARKET,1996-09-03,5962,24456,     267,    1636,86286,    8234,-18494
1484,JAPANESE YEN - INTERNATIONAL MONETARY MARKET,1996-08-27,5695,22820,   -1530,    2700,78052,    6351,-17125
1485,JAPANESE YEN - INTERNATIONAL MONETARY MARKET,1996-08-20,7225,20120,     455,    1214,71701,    3257,-12895
1486,JAPANESE YEN - INTERNATIONAL MONETARY MARKET,1996-08-13,6770,18906,   -2111,     727,68444,   -2845,-12136
1487,JAPANESE YEN - INTERNATIONAL MONETARY MARKET,1996-08-06,8881,18179,    6224,   -8846,71289,    -752,-9298
1488,JAPANESE YEN - INTERNATIONAL MONETARY MARKET,1996-07-30,2657,27025,     -34,     653,72041,    -166,-24368
1489,JAPANESE YEN - INTERNATIONAL MONETARY MARKET,1996-07-23,2691,26372,     683,   -5982,72207,   -7699,-23681
1490,JAPANESE YEN - INTERNATIONAL MONETARY MARKET,1996-07-16,2008,32354,    -104,   -4009,79906,   -2914,-30346
1491,JAPANESE YEN - INTERNATIONAL MONETARY MARKET,1996-07-09,2112,36363,     653,     716,82820,     793,-34251
1492,JAPANESE YEN - INTERNATIONAL MONETARY MARKET,1996-07-02,1459,35647,     140,    6272,82027,   10829,-34188
1493,JAPANESE YEN - INTERNATIONAL MONETARY MARKET,1996-06-25,1319,29375,     519,    -610,71198,     605,-28056
1494,JAPANESE YEN - INTERNATIONAL MONETARY MARKET,1996-06-18,800,29985,   -1209,   -2772,70593,  -28167,-29185
1495,JAPANESE YEN - INTERNATIONAL MONETARY MARKET,1996-06-11,2009,32757,     478,    1144,98760,    8487,-30748
1496,JAPANESE YEN - INTERNATIONAL MONETARY MARKET,1996-06-04,1531,31613,   -2205,    4006,90273,    5661,-30082
1497,JAPANESE YEN - INTERNATIONAL MONETARY MARKET,1996-05-28,3736,27607,    -599,    7766,84612,    9158,-23871
1498,JAPANESE YEN - INTERNATIONAL MONETARY MARKET,1996-05-21,4335,19841,   -3213,    2269,75454,    6469,-15506
1499,JAPANESE YEN - INTERNATIONAL MONETARY MARKET,1996-05-14,7548,17572,   -1966,    -453,68985,    -250,-10024
1500,JAPANESE YEN - INTERNATIONAL MONETARY MARKET,1996-05-07,9514,18025,     790,     114,69235,     745,-8511
1501,JAPANESE YEN - INTERNATIONAL MONETARY MARKET,1996-04-30,8724,17911,    6064,   -6675,68490,   -2142,-9187
1502,JAPANESE YEN - INTERNATIONAL MONETARY MARKET,1996-04-23,2660,24586,    -111,  -10759,70632,   -9997,-21926
1503,JAPANESE YEN - INTERNATIONAL MONETARY MARKET,1996-04-16,2771,35345,     700,   -2421,80629,   -3344,-32574
1504,JAPANESE YEN - INTERNATIONAL MONETARY MARKET,1996-04-09,2071,37766,    1031,    2826,83973,    6029,-35695
1505,JAPANESE YEN - INTERNATIONAL MONETARY MARKET,1996-04-02,1040,34940,     779,    5015,77944,    9844,-33900
1506,JAPANESE YEN - INTERNATIONAL MONETARY MARKET,1996-03-26,261,29925,    -252,    5054,68100,    9254,-29664
1507,JAPANESE YEN - INTERNATIONAL MONETARY MARKET,1996-03-19,513,24871,   -1182,    3464,58846,  -15395,-24358
1508,JAPANESE YEN - INTERNATIONAL MONETARY MARKET,1996-03-12,1695,21407,    -290,    -423,74241,    4042,-19712
1509,JAPANESE YEN - INTERNATIONAL MONETARY MARKET,1996-03-05,1985,21830,   -1929,   -2753,70199,   -3557,-19845
1510,JAPANESE YEN - INTERNATIONAL MONETARY MARKET,1996-02-27,3914,24583,    1936,   -6020,73756,   -5870,-20669
1511,JAPANESE YEN - INTERNATIONAL MONETARY MARKET,1996-02-20,1978,30603,     686,   -1267,79626,   -1820,-28625
1512,JAPANESE YEN - INTERNATIONAL MONETARY MARKET,1996-02-13,1292,31870,     685,     328,81446,    5058,-30578
1513,JAPANESE YEN - INTERNATIONAL MONETARY MARKET,1996-02-06,607,31542,    -478,   -6578,76388,   -8329,-30935
1514,JAPANESE YEN - INTERNATIONAL MONETARY MARKET,1996-01-30,1085,38120,    -257,     980,84717,    4261,-37035
1515,JAPANESE YEN - INTERNATIONAL MONETARY MARKET,1996-01-23,1342,37140,      68,   -1122,80456,   -3828,-35798
1516,JAPANESE YEN - INTERNATIONAL MONETARY MARKET,1996-01-16,1274,38262,    -304,    3428,84284,    6057,-36988
1517,JAPANESE YEN - INTERNATIONAL MONETARY MARKET,1996-01-09,1578,34834,     250,    1207,78227,    6337,-33256
1518,JAPANESE YEN - INTERNATIONAL MONETARY MARKET,1996-01-02,1328,33627,     552,    4777,71890,    8677,-32299
1519,JAPANESE YEN - INTERNATIONAL MONETARY MARKET,1995-12-26,776,28850,     103,    5133,63213,    7487,-28074
1520,JAPANESE YEN - INTERNATIONAL MONETARY MARKET,1995-12-19,673,23717,   -3123,     647,55726,  -22730,-23044
1521,JAPANESE YEN - INTERNATIONAL MONETARY MARKET,1995-12-12,3796,23070,     598,    1108,78456,    7464,-19274
1522,JAPANESE YEN - INTERNATIONAL MONETARY MARKET,1995-12-05,3198,21962,    -231,    -599,70992,   -1469,-18764
1523,JAPANESE YEN - INTERNATIONAL MONETARY MARKET,1995-11-28,3429,22561,     -61,   -1593,72461,    -501,-19132
1524,JAPANESE YEN - INTERNATIONAL MONETARY MARKET,1995-11-21,3490,24154,    3007,     622,72962,    1837,-20664
1525,JAPANESE YEN - INTERNATIONAL MONETARY MARKET,1995-11-14,483,23532,    -350,   -2364,71125,   -5719,-23049
1526,JAPANESE YEN - INTERNATIONAL MONETARY MARKET,1995-11-07,833,25896,      21,    2872,76844,    5723,-25063
1527,JAPANESE YEN - INTERNATIONAL MONETARY MARKET,1995-10-31,812,23024,    -655,    1510,71121,    4619,-22212
1528,JAPANESE YEN - INTERNATIONAL MONETARY MARKET,1995-10-24,1467,21514,    -227,   -1344,66502,    1172,-20047
1529,JAPANESE YEN - INTERNATIONAL MONETARY MARKET,1995-10-17,1694,22858,     366,     747,65330,   -1730,-21164
1530,JAPANESE YEN - INTERNATIONAL MONETARY MARKET,1995-10-10,1328,22111,    -203,    -381,67060,     134,-20783
1531,JAPANESE YEN - INTERNATIONAL MONETARY MARKET,1995-10-03,1531,22492,      22,     772,66926,    2075,-20961
1532,JAPANESE YEN - INTERNATIONAL MONETARY MARKET,1995-09-26,1509,21720,   -1317,     484,64851,   -1395,-20211
1533,JAPANESE YEN - INTERNATIONAL MONETARY MARKET,1995-09-19,2826,21236,    -483,    -512,66246,  -18516,-18410
1534,JAPANESE YEN - INTERNATIONAL MONETARY MARKET,1995-09-12,3309,21748,    -672,    2425,84762,   14864,-18439
1535,JAPANESE YEN - INTERNATIONAL MONETARY MARKET,1995-09-05,3981,19323,   -1157,      51,69898,    -519,-15342
1536,JAPANESE YEN - INTERNATIONAL MONETARY MARKET,1995-08-29,5138,19272,     -86,   -1501,70417,    3859,-14134
1537,JAPANESE YEN - INTERNATIONAL MONETARY MARKET,1995-08-22,5224,20773,    2444,    1275,66558,    4197,-15549
1538,JAPANESE YEN - INTERNATIONAL MONETARY MARKET,1995-08-15,2780,19498,   -1147,     987,62361,    1979,-16718
1539,JAPANESE YEN - INTERNATIONAL MONETARY MARKET,1995-08-08,3927,18511,    1054,    2679,60382,    7992,-14584
1540,JAPANESE YEN - INTERNATIONAL MONETARY MARKET,1995-08-01,2873,15832,     386,    -321,52390,    -627,-12959
1541,JAPANESE YEN - INTERNATIONAL MONETARY MARKET,1995-07-25,2487,16153,   -1279,     129,53017,    1180,-13666
1542,JAPANESE YEN - INTERNATIONAL MONETARY MARKET,1995-07-18,3766,16024,      -8,    1324,51837,    3984,-12258
1543,JAPANESE YEN - INTERNATIONAL MONETARY MARKET,1995-07-11,3774,14700,    1541,    3421,47853,    8872,-10926
1544,JAPANESE YEN - INTERNATIONAL MONETARY MARKET,1995-07-03,2233,11279,   -1472,    3698,38981,    3133,-9046
1545,JAPANESE YEN - INTERNATIONAL MONETARY MARKET,1995-06-27,3705,7581,     595,   -1046,35848,     660,-3876
1546,JAPANESE YEN - INTERNATIONAL MONETARY MARKET,1995-06-20,3110,8627,   -1656,    -959,35188,  -35704,-5517
1547,JAPANESE YEN - INTERNATIONAL MONETARY MARKET,1995-06-13,4766,9586,   -1944,    -898,70892,    2818,-4820
1548,JAPANESE YEN - INTERNATIONAL MONETARY MARKET,1995-06-06,6710,10484,       5,    1400,68074,   -1629,-3774
1549,JAPANESE YEN - INTERNATIONAL MONETARY MARKET,1995-05-30,6705,9084,    1695,   -3610,69703,    2582,-2379
1550,JAPANESE YEN - INTERNATIONAL MONETARY MARKET,1995-05-23,5010,12694,   -1314,    2431,67121,   -1604,-7684
1551,JAPANESE YEN - INTERNATIONAL MONETARY MARKET,1995-05-16,6324,10263,   -2771,    1936,68725,   -1439,-3939
1552,JAPANESE YEN - INTERNATIONAL MONETARY MARKET,1995-05-09,9095,8327,    -359,    2546,70164,    6329,768
1553,JAPANESE YEN - INTERNATIONAL MONETARY MARKET,1995-05-02,9454,5781,     -23,    1109,63835,    -197,3673
1554,JAPANESE YEN - INTERNATIONAL MONETARY MARKET,1995-04-25,9477,4672,   -2819,   -2474,64032,   -1232,4805
1555,JAPANESE YEN - INTERNATIONAL MONETARY MARKET,1995-04-18,12296,7146,    1789,    1406,65264,    2273,5150
1556,JAPANESE YEN - INTERNATIONAL MONETARY MARKET,1995-04-11,10507,5740,   -3574,   -2714,62991,    1793,4767
1557,JAPANESE YEN - INTERNATIONAL MONETARY MARKET,1995-04-04,14081,8454,    -509,   -1139,61198,    2391,5627
1558,JAPANESE YEN - INTERNATIONAL MONETARY MARKET,1995-03-28,14590,9593,   -2008,     271,58807,    -598,4997
1559,JAPANESE YEN - INTERNATIONAL MONETARY MARKET,1995-03-21,16598,9322,    1617,    -494,59405,  -37650,7276
1560,JAPANESE YEN - INTERNATIONAL MONETARY MARKET,1995-03-14,14981,9816,    -327,   -3296,97055,  -13525,5165
1561,JAPANESE YEN - INTERNATIONAL MONETARY MARKET,1995-03-07,15308,13112,    5433,    2367,110580,   16124,2196
1562,JAPANESE YEN - INTERNATIONAL MONETARY MARKET,1995-02-28,9875,10745,    3758,     820,94456,    4267,-870
1563,JAPANESE YEN - INTERNATIONAL MONETARY MARKET,1995-02-21,6117,9925,    4271,  -15584,90189,    6397,-3808
1564,JAPANESE YEN - INTERNATIONAL MONETARY MARKET,1995-02-14,1846,25509,     202,   -3645,83792,   -1108,-23663
1565,JAPANESE YEN - INTERNATIONAL MONETARY MARKET,1995-02-07,1644,29154,    -549,     722,84900,    -372,-27510
1566,JAPANESE YEN - INTERNATIONAL MONETARY MARKET,1995-01-31,2193,28432,     251,    1596,85272,    1840,-26239
1567,JAPANESE YEN - INTERNATIONAL MONETARY MARKET,1995-01-24,1942,26836,    -341,     372,83432,   -2702,-24894
1568,JAPANESE YEN - INTERNATIONAL MONETARY MARKET,1995-01-17,2283,26464,    1515,  -14604,86134,   -5747,-24181
1569,JAPANESE YEN - INTERNATIONAL MONETARY MARKET,1995-01-10,768,41068,     174,    6750,91881,   12819,-40300
1570,JAPANESE YEN - INTERNATIONAL MONETARY MARKET,1995-01-03,594,34318,   -1939,    1136,79062,    3638,-33724
1571,JAPANESE YEN - INTERNATIONAL MONETARY MARKET,1994-12-27,2533,33182,     689,     838,75424,  -24197,-30649
1572,JAPANESE YEN - INTERNATIONAL MONETARY MARKET,1994-12-20,1844,32344,   -1030,   -8068,99621,   -4857,-30500
1573,JAPANESE YEN - INTERNATIONAL MONETARY MARKET,1994-12-13,2874,40412,    -814,    1000,104478,    2774,-37538
1574,JAPANESE YEN - INTERNATIONAL MONETARY MARKET,1994-12-06,3688,39412,   -1310,    9137,101704,   12774,-35724
1575,JAPANESE YEN - INTERNATIONAL MONETARY MARKET,1994-11-29,4998,30275,     323,    1795,88930,    1971,-25277
1576,JAPANESE YEN - INTERNATIONAL MONETARY MARKET,1994-11-22,4675,28480,    -756,    5635,86959,    6330,-23805
1577,JAPANESE YEN - INTERNATIONAL MONETARY MARKET,1994-11-15,5431,22845,   -1826,    5323,80629,    5605,-17414
1578,JAPANESE YEN - INTERNATIONAL MONETARY MARKET,1994-11-08,7257,17522,    -697,    4459,75024,    4647,-10265
1579,JAPANESE YEN - INTERNATIONAL MONETARY MARKET,1994-11-01,7954,13063,    -684,     996,70377,    1910,-5109
1580,JAPANESE YEN - INTERNATIONAL MONETARY MARKET,1994-10-25,8638,12067,    3066,   -1060,68467,    5444,-3429
1581,JAPANESE YEN - INTERNATIONAL MONETARY MARKET,1994-10-18,5572,13127,    2432,   -3432,63023,    -701,-7555
1582,JAPANESE YEN - INTERNATIONAL MONETARY MARKET,1994-10-11,3140,16559,      24,    5904,63724,   11388,-13419
1583,JAPANESE YEN - INTERNATIONAL MONETARY MARKET,1994-10-04,3116,10655,   -1552,    3391,52336,    4176,-7539
1584,JAPANESE YEN - INTERNATIONAL MONETARY MARKET,1994-09-27,4668,7264,   -1930,    -786,48160,  -24815,-2596
1585,JAPANESE YEN - INTERNATIONAL MONETARY MARKET,1994-09-20,6598,8050,    4344,   -4300,72975,    2949,-1452
1586,JAPANESE YEN - INTERNATIONAL MONETARY MARKET,1994-09-13,2254,12350,   -1319,   -1822,70026,   -2513,-10096
1587,JAPANESE YEN - INTERNATIONAL MONETARY MARKET,1994-09-06,3573,14172,    -761,   -1388,72539,     449,-10599
1588,JAPANESE YEN - INTERNATIONAL MONETARY MARKET,1994-08-30,4334,15560,   -2032,     511,72090,   -2257,-11226
1589,JAPANESE YEN - INTERNATIONAL MONETARY MARKET,1994-08-23,6366,15049,    1511,   -1460,74347,    2187,-8683
1590,JAPANESE YEN - INTERNATIONAL MONETARY MARKET,1994-08-16,4855,16509,    1638,     -25,72160,   -1314,-11654
1591,JAPANESE YEN - INTERNATIONAL MONETARY MARKET,1994-08-09,3217,16534,   -1865,    2471,73474,      61,-13317
1592,JAPANESE YEN - INTERNATIONAL MONETARY MARKET,1994-08-02,5082,14063,   -3886,    1589,73413,   -2335,-8981
1593,JAPANESE YEN - INTERNATIONAL MONETARY MARKET,1994-07-26,8968,12474,    -527,   -1100,75748,     552,-3506
1594,JAPANESE YEN - INTERNATIONAL MONETARY MARKET,1994-07-19,9495,13574,   -1371,    3424,75196,    1216,-4079
1595,JAPANESE YEN - INTERNATIONAL MONETARY MARKET,1994-07-12,10866,10150,     281,    1748,73980,    5561,716
1596,JAPANESE YEN - INTERNATIONAL MONETARY MARKET,1994-07-05,10585,8402,    1593,   -4387,68419,    2868,2183
1597,JAPANESE YEN - INTERNATIONAL MONETARY MARKET,1994-06-28,8992,12789,    1571,    2038,65551,    2477,-3797
1598,JAPANESE YEN - INTERNATIONAL MONETARY MARKET,1994-06-21,7421,10751,    2884,   -3250,63074,  -16852,-3330
1599,JAPANESE YEN - INTERNATIONAL MONETARY MARKET,1994-06-14,4537,14001,    3046,   -5493,79926,   -4126,-9464
1600,JAPANESE YEN - INTERNATIONAL MONETARY MARKET,1994-06-07,1491,19494,   -2282,    1608,84052,   12777,-18003
1601,JAPANESE YEN - INTERNATIONAL MONETARY MARKET,1994-05-31,3773,17886,   -1371,   -1532,71275,    1060,-14113
1602,JAPANESE YEN - INTERNATIONAL MONETARY MARKET,1994-05-24,5144,19418,     874,    4545,70215,    6033,-14274
1603,JAPANESE YEN - INTERNATIONAL MONETARY MARKET,1994-05-17,4270,14873,   -1809,      47,64182,    1712,-10603
1604,JAPANESE YEN - INTERNATIONAL MONETARY MARKET,1994-05-10,6079,14826,   -6967,    3132,62470,   -4649,-8747
1605,JAPANESE YEN - INTERNATIONAL MONETARY MARKET,1994-05-03,13046,11694,    3825,    2162,67119,    8237,1352
1606,JAPANESE YEN - INTERNATIONAL MONETARY MARKET,1994-04-26,9221,9532,     123,   -2034,58882,    1986,-311
1607,JAPANESE YEN - INTERNATIONAL MONETARY MARKET,1994-04-19,9098,11566,    -203,    -861,56896,     936,-2468
1608,JAPANESE YEN - INTERNATIONAL MONETARY MARKET,1994-04-12,9301,12427,   -1830,     889,55960,   -1141,-3126
1609,JAPANESE YEN - INTERNATIONAL MONETARY MARKET,1994-04-05,11131,11538,    5628,     -20,57101,    3814,-407
1610,JAPANESE YEN - INTERNATIONAL MONETARY MARKET,1994-03-29,5503,11558,    2172,    -752,53287,    2779,-6055
1611,JAPANESE YEN - INTERNATIONAL MONETARY MARKET,1994-03-22,3331,12310,   -6366,     644,50508,  -44435,-8979
1612,JAPANESE YEN - INTERNATIONAL MONETARY MARKET,1994-03-15,9697,11666,   -3942,    1161,94943,    1092,-1969
1613,JAPANESE YEN - INTERNATIONAL MONETARY MARKET,1994-03-08,13639,10505,   -5743,    -349,93851,   -5002,3134
1614,JAPANESE YEN - INTERNATIONAL MONETARY MARKET,1994-03-01,19382,10854,   -2603,    2069,98853,   -1270,8528
1615,JAPANESE YEN - INTERNATIONAL MONETARY MARKET,1994-02-22,21985,8785,    -663,   -2696,100123,   -3008,13200
1616,JAPANESE YEN - INTERNATIONAL MONETARY MARKET,1994-02-15,22648,11481,   13948,   -3585,103131,   16697,11167
1617,JAPANESE YEN - INTERNATIONAL MONETARY MARKET,1994-02-08,8700,15066,    4294,    1141,86434,    1573,-6366
1618,JAPANESE YEN - INTERNATIONAL MONETARY MARKET,1994-02-01,4406,13925,    1056,  -22388,84861,  -15410,-9519
1619,JAPANESE YEN - INTERNATIONAL MONETARY MARKET,1994-01-25,3350,36313,  -20109,   -5756,100271,   -6288,-32963
1620,JAPANESE YEN - INTERNATIONAL MONETARY MARKET,1994-01-18,23459,42069,    -461,   -2442,106559,     578,-18610
1621,JAPANESE YEN - INTERNATIONAL MONETARY MARKET,1994-01-11,23920,44511,   -1608,   -3287,105981,    2160,-20591
1622,JAPANESE YEN - INTERNATIONAL MONETARY MARKET,1994-01-04,25528,47798,   22232,    1403,103821,    3485,-22270
1623,JAPANESE YEN - INTERNATIONAL MONETARY MARKET,1993-12-28,3296,46395,    -302,      70,100336,   -1254,-43099
1624,JAPANESE YEN - INTERNATIONAL MONETARY MARKET,1993-12-21,3598,46325,    1049,   17912,101590,    3479,-42727
1625,JAPANESE YEN - INTERNATIONAL MONETARY MARKET,1993-12-14,2549,28413,     231,    6323,98111,    7750,-25864
1626,JAPANESE YEN - INTERNATIONAL MONETARY MARKET,1993-12-07,2318,22090,      53,   -2807,90361,   -2414,-19772
1627,JAPANESE YEN - INTERNATIONAL MONETARY MARKET,1993-11-30,2265,24897,     331,    8160,92775,   10387,-22632
1628,JAPANESE YEN - INTERNATIONAL MONETARY MARKET,1993-11-23,1934,16737,   -3430,    1318,82388,    5813,-14803
1629,JAPANESE YEN - INTERNATIONAL MONETARY MARKET,1993-11-16,5364,15419,    3133,  -17392,76575,  -17169,-10055
1630,JAPANESE YEN - INTERNATIONAL MONETARY MARKET,1993-11-09,2231,32811,    1021,   -1193,93744,     143,-30580
1631,JAPANESE YEN - INTERNATIONAL MONETARY MARKET,1993-11-02,1210,34004,    -221,   -7521,93601,   -9174,-32794
1632,JAPANESE YEN - INTERNATIONAL MONETARY MARKET,1993-10-26,1431,41525,    -626,    6420,102775,    9003,-40094
1633,JAPANESE YEN - INTERNATIONAL MONETARY MARKET,1993-10-19,2057,35105,    -197,   19602,93772,   28766,-33048
1634,JAPANESE YEN - INTERNATIONAL MONETARY MARKET,1993-10-12,2254,15503,    -139,     131,65006,    4364,-13249
1635,JAPANESE YEN - INTERNATIONAL MONETARY MARKET,1993-10-05,2393,15372,   -1834,    1592,60642,    1433,-12979
1636,JAPANESE YEN - INTERNATIONAL MONETARY MARKET,1993-09-28,4227,13780,    1461,   -2658,59209,     -82,-9553
1637,JAPANESE YEN - INTERNATIONAL MONETARY MARKET,1993-09-21,2766,16438,   -2586,    3266,59291,  -25174,-13672
1638,JAPANESE YEN - INTERNATIONAL MONETARY MARKET,1993-09-14,5352,13172,  -12480,     632,84465,   -1963,-7820
1639,JAPANESE YEN - INTERNATIONAL MONETARY MARKET,1993-09-07,17832,12540,   -8254,    1581,86428,    3487,5292
1640,JAPANESE YEN - INTERNATIONAL MONETARY MARKET,1993-08-31,26086,10959,   -1935,     740,82941,    1259,15127
1641,JAPANESE YEN - INTERNATIONAL MONETARY MARKET,1993-08-24,28021,10219,   -6498,     337,81682,   -4228,17802
1642,JAPANESE YEN - INTERNATIONAL MONETARY MARKET,1993-08-17,34519,9882,    4777,     351,85910,    8564,24637
1643,JAPANESE YEN - INTERNATIONAL MONETARY MARKET,1993-08-10,29742,9531,   -3125,    2249,77346,   -1389,20211
1644,JAPANESE YEN - INTERNATIONAL MONETARY MARKET,1993-08-03,32867,7282,    3335,   -1340,78735,    3537,25585
1645,JAPANESE YEN - INTERNATIONAL MONETARY MARKET,1993-07-27,29532,8622,    8756,   -1418,75198,    4195,20910
1646,JAPANESE YEN - INTERNATIONAL MONETARY MARKET,1993-07-20,20776,10040,   -1862,    -518,71003,   -2419,10736
1647,JAPANESE YEN - INTERNATIONAL MONETARY MARKET,1993-07-13,22638,10558,   -1322,     383,73422,    6048,12080
1648,JAPANESE YEN - INTERNATIONAL MONETARY MARKET,1993-07-06,23960,10175,    -873,    1846,67374,    1467,13785
1649,JAPANESE YEN - INTERNATIONAL MONETARY MARKET,1993-06-29,24833,8329,    3536,     943,65907,    1735,16504
1650,JAPANESE YEN - INTERNATIONAL MONETARY MARKET,1993-06-22,21297,7386,  -13258,    2024,64172,  -32453,13911
1651,JAPANESE YEN - INTERNATIONAL MONETARY MARKET,1993-06-15,34555,5362,    3539,     807,96625,   -2094,29193
1652,JAPANESE YEN - INTERNATIONAL MONETARY MARKET,1993-06-08,31016,4555,    1023,     321,98719,    6494,26461
1653,JAPANESE YEN - INTERNATIONAL MONETARY MARKET,1993-06-01,29993,4234,    -267,     460,92225,    2917,25759
1654,JAPANESE YEN - INTERNATIONAL MONETARY MARKET,1993-05-25,30260,3774,    5192,    -247,89308,   10959,26486
1655,JAPANESE YEN - INTERNATIONAL MONETARY MARKET,1993-05-18,25068,4021,    2900,    -761,78349,    1520,21047
1656,JAPANESE YEN - INTERNATIONAL MONETARY MARKET,1993-05-11,22168,4782,   -1865,     282,76829,   -1905,17386
1657,JAPANESE YEN - INTERNATIONAL MONETARY MARKET,1993-05-04,24033,4500,      68,    -588,78734,    1718,19533
1658,JAPANESE YEN - INTERNATIONAL MONETARY MARKET,1993-04-27,23965,5088,   -3771,    -118,77016,   -3372,18877
1659,JAPANESE YEN - INTERNATIONAL MONETARY MARKET,1993-04-20,27736,5206,     270,     108,80388,    2293,22530
1660,JAPANESE YEN - INTERNATIONAL MONETARY MARKET,1993-04-13,27466,5098,     -11,   -9195,78095,    4955,22368
1661,JAPANESE YEN - INTERNATIONAL MONETARY MARKET,1993-04-06,27477,14293,    3022,    -234,73140,    4195,13184
1662,JAPANESE YEN - INTERNATIONAL MONETARY MARKET,1993-03-30,24455,14527,   -6329,     799,68945,   -4280,9928
1663,JAPANESE YEN - INTERNATIONAL MONETARY MARKET,1993-03-23,30784,13728,    1138,   -3392,73225,  -29279,17056
1664,JAPANESE YEN - INTERNATIONAL MONETARY MARKET,1993-03-16,29646,17120,    3986,    8822,102504,   10769,12526
1665,JAPANESE YEN - INTERNATIONAL MONETARY MARKET,1993-03-09,25660,8298,   -3157,   -1556,91735,    5694,17362
1666,JAPANESE YEN - INTERNATIONAL MONETARY MARKET,1993-03-02,28817,9854,   -1165,     228,86041,    1689,18963
1667,JAPANESE YEN - INTERNATIONAL MONETARY MARKET,1993-02-23,29982,9626,    3941,     282,84352,    7135,20356
1668,JAPANESE YEN - INTERNATIONAL MONETARY MARKET,1993-02-16,26041,9344,    7941,    -339,77217,    9625,16697
1669,JAPANESE YEN - INTERNATIONAL MONETARY MARKET,1993-02-09,18100,9683,   11814,    -772,67592,   17908,8417
1670,JAPANESE YEN - INTERNATIONAL MONETARY MARKET,1993-02-02,6286,10455,     832,   -1055,49684,    -583,-4169
1671,JAPANESE YEN - INTERNATIONAL MONETARY MARKET,1993-01-26,5454,11510,    3661,   -7983,50267,   -2956,-6056
1672,JAPANESE YEN - INTERNATIONAL MONETARY MARKET,1993-01-19,1793,19493,   -1424,    3383,53223,    4228,-17700
1673,JAPANESE YEN - INTERNATIONAL MONETARY MARKET,1993-01-12,3217,16110,    -744,     799,48995,    1247,-12893
1674,JAPANESE YEN - INTERNATIONAL MONETARY MARKET,1993-01-05,3961,15311,    -897,    1328,47748,    3858,-11350
1675,JAPANESE YEN - INTERNATIONAL MONETARY MARKET,1992-12-29,4858,13983,   -4709,    4457,43890,    3450,-9125
1676,JAPANESE YEN - INTERNATIONAL MONETARY MARKET,1992-12-22,9567,9526,    3508,     640,40440,  -11267,41
1677,JAPANESE YEN - INTERNATIONAL MONETARY MARKET,1992-12-15,6059,8886,    1935,   -1027,51707,   -3506,-2827
1678,JAPANESE YEN - INTERNATIONAL MONETARY MARKET,1992-12-08,4124,9913,   -1726,      87,55213,    5598,-5789
1679,JAPANESE YEN - INTERNATIONAL MONETARY MARKET,1992-12-01,5850,9826,    -293,    -768,49615,    2831,-3976
1680,JAPANESE YEN - INTERNATIONAL MONETARY MARKET,1992-11-24,6143,10594,     507,     151,46784,   -1378,-4451
1681,JAPANESE YEN - INTERNATIONAL MONETARY MARKET,1992-11-17,5636,10443,   -2728,     279,48162,    4819,-4807
1682,JAPANESE YEN - INTERNATIONAL MONETARY MARKET,1992-11-10,8364,10164,   -1974,    1451,43343,      96,-1800
1683,JAPANESE YEN - INTERNATIONAL MONETARY MARKET,1992-11-03,10338,8713,   -2059,     924,43247,   -1262,1625
1684,JAPANESE YEN - INTERNATIONAL MONETARY MARKET,1992-10-27,12397,7789,   -1104,      99,44509,    -780,4608
1685,JAPANESE YEN - INTERNATIONAL MONETARY MARKET,1992-10-20,13501,7690,    3154,     998,45289,    4981,5811
1686,JAPANESE YEN - INTERNATIONAL MONETARY MARKET,1992-10-13,10347,6692,   -3178,      67,40308,   -7013,3655
1687,JAPANESE YEN - INTERNATIONAL MONETARY MARKET,1992-10-06,13525,6625,     389,    -472,47321,    1401,6900
1688,JAPANESE YEN - INTERNATIONAL MONETARY MARKET,1992-09-30,13136,7097,    2693,   -1723,45920,  -15254,6039
1689,JAPANESE YEN - INTERNATIONAL MONETARY MARKET,1992-09-15,10443,8820,    1244,     988,61174,   -5907,1623
1690,JAPANESE YEN - INTERNATIONAL MONETARY MARKET,1992-08-31,9199,7832,    4028,   -3604,67081,   11832,1367
1691,JAPANESE YEN - INTERNATIONAL MONETARY MARKET,1992-08-14,5171,11436,    2167,   -2573,55249,    -968,-6265
1692,JAPANESE YEN - INTERNATIONAL MONETARY MARKET,1992-07-31,3004,14009,   -4620,    5226,56217,   -1243,-11005
1693,JAPANESE YEN - INTERNATIONAL MONETARY MARKET,1992-07-15,7624,8783,     769,    1669,57460,    3307,-1159
1694,JAPANESE YEN - INTERNATIONAL MONETARY MARKET,1992-06-30,6855,7114,   -4525,    -803,54153,  -18977,-259
1695,JAPANESE YEN - INTERNATIONAL MONETARY MARKET,1992-06-15,11380,7917,    1772,     -70,73130,    5522,3463
1696,JAPANESE YEN - INTERNATIONAL MONETARY MARKET,1992-05-29,9608,7987,    3057,   -2782,67608,    6547,1621
1697,JAPANESE YEN - INTERNATIONAL MONETARY MARKET,1992-05-15,6551,10769,    3739,   -6270,61061,   -1889,-4218
1698,JAPANESE YEN - INTERNATIONAL MONETARY MARKET,1992-04-30,2812,17039,.,.,62950,.,-14227
1699,JAPANESE YEN - INTERNATIONAL MONETARY MARKET,1992-04-15,1527,17620,   -7309,   -4787,61269,    1522,-16093
1700,JAPANESE YEN - INTERNATIONAL MONETARY MARKET,1992-03-31,8836,22407,    6227,    1017,59747,  -26666,-13571
1701,JAPANESE YEN - INTERNATIONAL MONETARY MARKET,1992-03-13,2609,21390,   -5542,    7600,86413,   14693,-18781
1702,JAPANESE YEN - INTERNATIONAL MONETARY MARKET,1992-02-28,8151,13790,   -4435,    5553,71720,    4824,-5639
1703,JAPANESE YEN - INTERNATIONAL MONETARY MARKET,1992-02-14,12586,8237,   -3604,   -1496,66896,    -319,4349
1704,JAPANESE YEN - INTERNATIONAL MONETARY MARKET,1992-01-31,16190,9733,    2876,     -92,67215,    8877,6457
1705,JAPANESE YEN - INTERNATIONAL MONETARY MARKET,1992-01-15,13314,9825,   -1865,    1227,58338,   -1536,3489
1706,JAPANESE YEN - INTERNATIONAL MONETARY MARKET,1991-12-31,15179,8598,    6757,     -93,59874,  -12950,6581
1707,JAPANESE YEN - INTERNATIONAL MONETARY MARKET,1991-12-13,8422,8691,   -3266,     919,72824,    2071,-269
1708,JAPANESE YEN - INTERNATIONAL MONETARY MARKET,1991-11-29,11688,7772,   -7013,     234,70753,   -6243,3916
1709,JAPANESE YEN - INTERNATIONAL MONETARY MARKET,1991-11-15,18701,7538,    2508,   -2565,76996,    8214,11163
1710,JAPANESE YEN - INTERNATIONAL MONETARY MARKET,1991-10-31,16193,10103,   -9998,    1787,68782,  -12483,6090
1711,JAPANESE YEN - INTERNATIONAL MONETARY MARKET,1991-10-15,26191,8316,    7486,   -1327,81265,   23051,17875
1712,JAPANESE YEN - INTERNATIONAL MONETARY MARKET,1991-09-30,18705,9643,    2119,    -369,58214,  -20958,9062
1713,JAPANESE YEN - INTERNATIONAL MONETARY MARKET,1991-09-16,16586,10012,   10418,     330,79172,   23065,6574
1714,JAPANESE YEN - INTERNATIONAL MONETARY MARKET,1991-08-30,6168,9682,   -7953,     462,56107,   -3964,-3514
1715,JAPANESE YEN - INTERNATIONAL MONETARY MARKET,1991-08-15,14121,9220,    7012,     136,60071,   11058,4901
1716,JAPANESE YEN - INTERNATIONAL MONETARY MARKET,1991-07-31,7109,9084,  -13591,    2176,49013,  -12267,-1975
1717,JAPANESE YEN - INTERNATIONAL MONETARY MARKET,1991-07-15,20700,6908,    8971,   -2231,61280,   13549,13792
1718,JAPANESE YEN - INTERNATIONAL MONETARY MARKET,1991-06-28,11729,9139,    5376,   -7291,47731,  -20595,2590
1719,JAPANESE YEN - INTERNATIONAL MONETARY MARKET,1991-06-14,6353,16430,    -894,    8675,68326,   14471,-10077
1720,JAPANESE YEN - INTERNATIONAL MONETARY MARKET,1991-05-31,7247,7755,   -3577,    -119,53855,    -459,-508
1721,JAPANESE YEN - INTERNATIONAL MONETARY MARKET,1991-05-15,10824,7874,    2016,    1093,54314,    3544,2950
1722,JAPANESE YEN - INTERNATIONAL MONETARY MARKET,1991-04-30,8808,6781,     301,   -1408,50770,    1369,2027
1723,JAPANESE YEN - INTERNATIONAL MONETARY MARKET,1991-04-15,8507,8189,    3222,   -6171,49401,    6426,318
1724,JAPANESE YEN - INTERNATIONAL MONETARY MARKET,1991-03-28,5285,14360,     804,    2321,42975,  -20887,-9075
1725,JAPANESE YEN - INTERNATIONAL MONETARY MARKET,1991-03-15,4481,12039,    -269,    1829,63862,    -232,-7558
1726,JAPANESE YEN - INTERNATIONAL MONETARY MARKET,1991-02-28,4750,10210,   -2269,    4924,64094,     107,-5460
1727,JAPANESE YEN - INTERNATIONAL MONETARY MARKET,1991-02-15,7019,5286,   -1164,   -1527,63987,    7313,1733
1728,JAPANESE YEN - INTERNATIONAL MONETARY MARKET,1991-01-31,8183,6813,    6102,   -2671,56674,   17137,1370
1729,JAPANESE YEN - INTERNATIONAL MONETARY MARKET,1991-01-15,2081,9484,     -90,   -6163,39537,   -4713,-7403
1730,JAPANESE YEN - INTERNATIONAL MONETARY MARKET,1990-12-31,2171,15647,   -1436,    5638,44250,  -35361,-13476
1731,JAPANESE YEN - INTERNATIONAL MONETARY MARKET,1990-12-14,3607,10009,   -4609,    1440,79611,     145,-6402
1732,JAPANESE YEN - INTERNATIONAL MONETARY MARKET,1990-11-30,8216,8569,   -2834,   -3001,79466,    -976,-353
1733,JAPANESE YEN - INTERNATIONAL MONETARY MARKET,1990-11-15,11050,11570,  -12159,    3492,80442,    3119,-520
1734,JAPANESE YEN - INTERNATIONAL MONETARY MARKET,1990-10-31,23209,8078,   -4282,   -2274,77323,    1863,15131
1735,JAPANESE YEN - INTERNATIONAL MONETARY MARKET,1990-10-15,27491,10352,    3576,   -7640,75460,    6351,17139
1736,JAPANESE YEN - INTERNATIONAL MONETARY MARKET,1990-09-28,23915,17992,     942,    3229,69109,  -21655,5923
1737,JAPANESE YEN - INTERNATIONAL MONETARY MARKET,1990-09-14,22973,14763,   -1984,     916,90764,   18174,8210
1738,JAPANESE YEN - INTERNATIONAL MONETARY MARKET,1990-08-31,24957,13847,    6472,    -449,72590,   10507,11110
1739,JAPANESE YEN - INTERNATIONAL MONETARY MARKET,1990-08-15,18485,14296,    2214,    3949,62083,     -53,4189
1740,JAPANESE YEN - INTERNATIONAL MONETARY MARKET,1990-07-31,16271,10347,   -9430,    -310,62136,   -8202,5924
1741,JAPANESE YEN - INTERNATIONAL MONETARY MARKET,1990-07-13,25701,10657,   15719,   -1989,70338,   25485,15044
1742,JAPANESE YEN - INTERNATIONAL MONETARY MARKET,1990-06-29,9982,12646,     913,    1781,44853,  -22191,-2664
1743,JAPANESE YEN - INTERNATIONAL MONETARY MARKET,1990-06-15,9069,10865,   -4097,    4125,67044,   -8113,-1796
1744,JAPANESE YEN - INTERNATIONAL MONETARY MARKET,1990-05-31,13166,6740,   -7066,   -5959,75157,   -7274,6426
1745,JAPANESE YEN - INTERNATIONAL MONETARY MARKET,1990-05-15,20232,12699,    7659,   -6561,82431,    8222,7533
1746,JAPANESE YEN - INTERNATIONAL MONETARY MARKET,1990-04-30,12573,19260,   -3495,   -1701,74209,    6337,-6687
1747,JAPANESE YEN - INTERNATIONAL MONETARY MARKET,1990-04-12,16068,20961,   -3495,   -5824,67872,    -194,-4893
1748,JAPANESE YEN - INTERNATIONAL MONETARY MARKET,1990-03-30,19563,26785,   11050,   -2623,68066,  -28233,-7222
1749,JAPANESE YEN - INTERNATIONAL MONETARY MARKET,1990-03-15,8513,29408,    1588,    1298,96299,   15832,-20895
1750,JAPANESE YEN - INTERNATIONAL MONETARY MARKET,1990-02-28,6925,28110,   -1899,   14834,80467,   17288,-21185
1751,JAPANESE YEN - INTERNATIONAL MONETARY MARKET,1990-02-15,8824,13276,    -140,    3713,63179,     548,-4452
1752,JAPANESE YEN - INTERNATIONAL MONETARY MARKET,1990-01-31,8964,9563,    3417,   -4151,62631,    4213,-599
1753,JAPANESE YEN - INTERNATIONAL MONETARY MARKET,1990-01-15,5547,13714,   -2192,    7157,58418,    8458,-8167
1754,JAPANESE YEN - INTERNATIONAL MONETARY MARKET,1989-12-29,7739,6557,    3182,   -5873,49960,   -9578,1182
1755,JAPANESE YEN - INTERNATIONAL MONETARY MARKET,1989-12-15,4557,12430,   -7765,     638,59538,   -6629,-7873
1756,JAPANESE YEN - INTERNATIONAL MONETARY MARKET,1989-11-30,12322,11792,    4647,    -790,66167,    6494,530
1757,JAPANESE YEN - INTERNATIONAL MONETARY MARKET,1989-11-15,7675,12582,    2938,    -517,59673,    4027,-4907
1758,JAPANESE YEN - INTERNATIONAL MONETARY MARKET,1989-10-31,4737,13099,     285,    3345,55646,    4991,-8362
1759,JAPANESE YEN - INTERNATIONAL MONETARY MARKET,1989-10-13,4452,9754,   -1884,    1971,50655,   -1397,-5302
1760,JAPANESE YEN - INTERNATIONAL MONETARY MARKET,1989-09-29,6336,7783,     497,  -19060,52052,  -37862,-1447
1761,JAPANESE YEN - INTERNATIONAL MONETARY MARKET,1989-09-15,5839,26843,     -25,    4343,89914,   16559,-21004
1762,JAPANESE YEN - INTERNATIONAL MONETARY MARKET,1989-08-31,5864,22500,    -902,    9163,73355,   16940,-16636
1763,JAPANESE YEN - INTERNATIONAL MONETARY MARKET,1989-08-15,6766,13337,   -1674,     769,56415,    -268,-6571
1764,JAPANESE YEN - INTERNATIONAL MONETARY MARKET,1989-07-31,8440,12568,    2976,    1800,56683,   10901,-4128
1765,JAPANESE YEN - INTERNATIONAL MONETARY MARKET,1989-07-14,5464,10768,     629,     802,45782,    1751,-5304
1766,JAPANESE YEN - INTERNATIONAL MONETARY MARKET,1989-06-30,4835,9966,   -9532,   -5261,44031,  -54699,-5131
1767,JAPANESE YEN - INTERNATIONAL MONETARY MARKET,1989-06-15,14367,15227,    3939,   -1689,98730,   23222,-860
1768,JAPANESE YEN - INTERNATIONAL MONETARY MARKET,1989-05-31,10428,16916,    2411,   -7241,75508,    6761,-6488
1769,JAPANESE YEN - INTERNATIONAL MONETARY MARKET,1989-05-15,8017,24157,    2526,    7648,68747,   16742,-16140
1770,JAPANESE YEN - INTERNATIONAL MONETARY MARKET,1989-04-28,5491,16509,    -623,   -1685,52005,    2121,-11018
1771,JAPANESE YEN - INTERNATIONAL MONETARY MARKET,1989-04-14,6114,18194,   -1600,   -6226,49884,   -1983,-12080
1772,JAPANESE YEN - INTERNATIONAL MONETARY MARKET,1989-03-31,7714,24420,     325,   -1542,51867,    2069,-16706
1773,JAPANESE YEN - INTERNATIONAL MONETARY MARKET,1989-03-15,7389,25962,   -1142,   14303,49798,    -940,-18573
1774,JAPANESE YEN - INTERNATIONAL MONETARY MARKET,1989-02-28,8531,11659,     400,    3343,50738,    2816,-3128
1775,JAPANESE YEN - INTERNATIONAL MONETARY MARKET,1989-02-15,8131,8316,   -2573,   -7642,47922,   -4142,-185
1776,JAPANESE YEN - INTERNATIONAL MONETARY MARKET,1989-01-31,10704,15958,    6974,    5512,52064,   13751,-5254
1777,JAPANESE YEN - INTERNATIONAL MONETARY MARKET,1989-01-13,3730,10446,    -475,    -511,38313,    5666,-6716
1778,JAPANESE YEN - INTERNATIONAL MONETARY MARKET,1988-12-30,4205,10957,   -1795,    4165,32647,  -21447,-6752
1779,JAPANESE YEN - INTERNATIONAL MONETARY MARKET,1988-12-15,6000,6792,   -7825,    2194,54094,   -1444,-792
1780,JAPANESE YEN - INTERNATIONAL MONETARY MARKET,1988-11-30,13825,4598,   -1807,     498,55538,    4266,9227
1781,JAPANESE YEN - INTERNATIONAL MONETARY MARKET,1988-11-15,15632,4100,    3127,   -1657,51272,    2390,11532
1782,JAPANESE YEN - INTERNATIONAL MONETARY MARKET,1988-10-31,12505,5757,    -552,   -2109,48882,     469,6748
1783,JAPANESE YEN - INTERNATIONAL MONETARY MARKET,1988-10-14,13057,7866,    9249,   -1724,48413,   16723,5191
1784,JAPANESE YEN - INTERNATIONAL MONETARY MARKET,1988-09-30,3808,9590,    -636,   -2733,31690,  -26251,-5782
1785,JAPANESE YEN - INTERNATIONAL MONETARY MARKET,1988-09-15,4444,12323,   -2062,   -8286,57941,   -5805,-7879
1786,JAPANESE YEN - INTERNATIONAL MONETARY MARKET,1988-08-31,6506,20609,   -2367,   10663,63746,   16375,-14103
1787,JAPANESE YEN - INTERNATIONAL MONETARY MARKET,1988-08-15,8873,9946,     228,    -494,47371,   -1891,-1073
1788,JAPANESE YEN - INTERNATIONAL MONETARY MARKET,1988-07-29,8645,10440,   -6843,     524,49262,   -3550,-1795
1789,JAPANESE YEN - INTERNATIONAL MONETARY MARKET,1988-07-15,15488,9916,    4930,   -1099,52812,   10262,5572
1790,JAPANESE YEN - INTERNATIONAL MONETARY MARKET,1988-06-30,10558,11015,    3161,    -872,42550,    6818,-457
1791,JAPANESE YEN - INTERNATIONAL MONETARY MARKET,1988-06-15,7397,11887,    -814,    3020,35732,  -14031,-4490
1792,JAPANESE YEN - INTERNATIONAL MONETARY MARKET,1988-05-31,8211,8867,   -1969,    3643,49763,   -1376,-656
1793,JAPANESE YEN - INTERNATIONAL MONETARY MARKET,1988-05-13,10180,5224,     -73,     625,51139,    7640,4956
1794,JAPANESE YEN - INTERNATIONAL MONETARY MARKET,1988-04-29,10253,4599,   -2588,    1654,43499,   -1979,5654
1795,JAPANESE YEN - INTERNATIONAL MONETARY MARKET,1988-04-15,12841,2945,   -4443,    -199,45478,   -8094,9896
1796,JAPANESE YEN - INTERNATIONAL MONETARY MARKET,1988-03-31,17284,3144,    2941,   -7493,53572,   11053,14140
1797,JAPANESE YEN - INTERNATIONAL MONETARY MARKET,1988-03-15,14343,10637,    3946,    3551,42519,  -19301,3706
1798,JAPANESE YEN - INTERNATIONAL MONETARY MARKET,1988-02-29,10397,7086,    2472,    3733,61820,    8326,3311
1799,JAPANESE YEN - INTERNATIONAL MONETARY MARKET,1988-02-12,7925,3353,   -5246,   -6584,53494,    -809,4572
1800,JAPANESE YEN - INTERNATIONAL MONETARY MARKET,1988-01-29,13171,9937,    2887,    1983,54303,    5698,3234
1801,JAPANESE YEN - INTERNATIONAL MONETARY MARKET,1988-01-15,10284,7954,   -1577,    2988,48605,    5949,2330
1802,JAPANESE YEN - INTERNATIONAL MONETARY MARKET,1987-12-31,11861,4966,    1236,    1292,42656,    6058,6895
1803,JAPANESE YEN - INTERNATIONAL MONETARY MARKET,1987-12-15,10625,3674,    -347,    1605,36598,  -23701,6951
1804,JAPANESE YEN - INTERNATIONAL MONETARY MARKET,1987-11-30,10972,2069,    2838,     400,60299,    7547,8903
1805,JAPANESE YEN - INTERNATIONAL MONETARY MARKET,1987-11-13,8134,1669,    -611,     514,52752,    6455,6465
1806,JAPANESE YEN - INTERNATIONAL MONETARY MARKET,1987-10-30,8745,1155,   -4247,     -30,46297,   -2940,7590
1807,JAPANESE YEN - INTERNATIONAL MONETARY MARKET,1987-10-15,12992,1185,    7339,   -3480,49237,   12179,11807
1808,JAPANESE YEN - INTERNATIONAL MONETARY MARKET,1987-09-30,5653,4665,   -3310,   -2169,37058,   -3875,988
1809,JAPANESE YEN - INTERNATIONAL MONETARY MARKET,1987-09-15,8963,6834,  -12484,    5165,40933,  -11972,2129
1810,JAPANESE YEN - INTERNATIONAL MONETARY MARKET,1987-08-31,21447,1669,   14782,   -6864,52905,   15585,19778
1811,JAPANESE YEN - INTERNATIONAL MONETARY MARKET,1987-08-14,6665,8533,   -2075,    2318,37320,   -1014,-1868
1812,JAPANESE YEN - INTERNATIONAL MONETARY MARKET,1987-07-31,8740,6215,    2069,    -866,38334,    2350,2525
1813,JAPANESE YEN - INTERNATIONAL MONETARY MARKET,1987-07-15,6671,7081,    2059,    1235,35984,    8015,-410
1814,JAPANESE YEN - INTERNATIONAL MONETARY MARKET,1987-06-30,4612,5846,   -3707,    4069,27969,  -12902,-1234
1815,JAPANESE YEN - INTERNATIONAL MONETARY MARKET,1987-06-15,8319,1777,   -7629,   -3960,40871,  -10810,6542
1816,JAPANESE YEN - INTERNATIONAL MONETARY MARKET,1987-05-29,15948,5737,    3395,    3429,51681,    7072,10211
1817,JAPANESE YEN - INTERNATIONAL MONETARY MARKET,1987-05-15,12553,2308,   -4711,    -880,44609,   -2801,10245
1818,JAPANESE YEN - INTERNATIONAL MONETARY MARKET,1987-04-30,17264,3188,   -1087,    1110,47410,     972,14076
1819,JAPANESE YEN - INTERNATIONAL MONETARY MARKET,1987-04-15,18351,2078,      -1,    -349,46438,    3156,16273
1820,JAPANESE YEN - INTERNATIONAL MONETARY MARKET,1987-03-31,18352,2427,    8665,     248,43282,    6006,15925
1821,JAPANESE YEN - INTERNATIONAL MONETARY MARKET,1987-03-13,9687,2179,     366,     402,37276,    5288,7508
1822,JAPANESE YEN - INTERNATIONAL MONETARY MARKET,1987-02-27,9321,1777,     101,    -473,31988,    1696,7544
1823,JAPANESE YEN - INTERNATIONAL MONETARY MARKET,1987-02-13,9220,2250,    2471,     965,30292,   -1872,6970
1824,JAPANESE YEN - INTERNATIONAL MONETARY MARKET,1987-01-30,6749,1285,   -3806,      -6,32164,    -903,5464
1825,JAPANESE YEN - INTERNATIONAL MONETARY MARKET,1987-01-15,10555,1291,    5157,    -315,33067,    9895,9264
1826,JAPANESE YEN - INTERNATIONAL MONETARY MARKET,1986-12-31,5398,1606,    2484,   -6441,23172,  -13894,3792
1827,JAPANESE YEN - INTERNATIONAL MONETARY MARKET,1986-12-15,2914,8047,    -452,   -1222,37066,   -3986,-5133
1828,JAPANESE YEN - INTERNATIONAL MONETARY MARKET,1986-11-28,3366,9269,     745,     272,41052,     505,-5903
1829,JAPANESE YEN - INTERNATIONAL MONETARY MARKET,1986-11-14,2621,8997,     457,   -2817,40547,   -2515,-6376
1830,JAPANESE YEN - INTERNATIONAL MONETARY MARKET,1986-10-31,2164,11814,   -3000,    9661,43062,   11018,-9650
1831,JAPANESE YEN - INTERNATIONAL MONETARY MARKET,1986-10-15,5164,2153,   -2443,     683,32044,    1581,3011
1832,JAPANESE YEN - INTERNATIONAL MONETARY MARKET,1986-09-30,7607,1470,    4553,  -10164,30463,  -15897,6137
1833,JAPANESE YEN - INTERNATIONAL MONETARY MARKET,1986-09-15,3054,11634,   -1720,    -531,46360,   -3211,-8580
1834,JAPANESE YEN - INTERNATIONAL MONETARY MARKET,1986-08-29,4774,12165,   -7582,    7325,49571,    6775,-7391
1835,JAPANESE YEN - INTERNATIONAL MONETARY MARKET,1986-08-15,12356,4840,   -5733,    3767,42796,   -4732,7516
1836,JAPANESE YEN - INTERNATIONAL MONETARY MARKET,1986-07-31,18089,1073,   -7061,    1073,47528,   -8278,17016
1837,JAPANESE YEN - INTERNATIONAL MONETARY MARKET,1986-07-15,25150,0,    5389,    -209,55806,   18363,25150
1838,JAPANESE YEN - INTERNATIONAL MONETARY MARKET,1986-06-30,19761,209,    8316,   -1522,37443,   -6814,19552
1839,JAPANESE YEN - INTERNATIONAL MONETARY MARKET,1986-06-13,11445,1731,   -7312,   -2695,44257,    5894,9714
1840,JAPANESE YEN - INTERNATIONAL MONETARY MARKET,1986-05-30,18757,4426,   -2323,   -5403,38363,   -3060,14331
1841,JAPANESE YEN - INTERNATIONAL MONETARY MARKET,1986-05-15,21080,9829,     491,    7231,41423,    3075,11251
1842,JAPANESE YEN - INTERNATIONAL MONETARY MARKET,1986-04-30,20589,2598,   10005,   -1493,38348,    9657,17991
1843,JAPANESE YEN - INTERNATIONAL MONETARY MARKET,1986-04-15,10584,4091,   -5774,    2402,28691,   -2614,6493
1844,JAPANESE YEN - INTERNATIONAL MONETARY MARKET,1986-03-31,16358,1689,   -2428,   -2476,31305,  -16017,14669
1845,JAPANESE YEN - INTERNATIONAL MONETARY MARKET,1986-03-14,18786,4165,    6957,    2417,47322,   13530,14621
1846,JAPANESE YEN - INTERNATIONAL MONETARY MARKET,1986-02-28,11829,1748,    -683,    -447,33792,    -660,10081
1847,JAPANESE YEN - INTERNATIONAL MONETARY MARKET,1986-02-14,12512,2195,   -1997,     864,34452,    2720,10317
1848,JAPANESE YEN - INTERNATIONAL MONETARY MARKET,1986-01-31,14509,1331,    6841,     616,31732,    8501,13178
1849,JAPANESE YEN - INTERNATIONAL MONETARY MARKET,1986-01-15,7668,715,.,.,23231,.,6953
